8	salinity	744	752	82	e during the hot-dry season and one during the cold-wet _NEW_LINE_              season. if the receiving water salinity is less than 1,000 mg/l then _NEW_LINE_              freshwater testing organisms shall be used. if the instre
8	salinity	2182	2190	82	eshwater organisms, (epa/600/4- _NEW_LINE_              89/001) or most recent edition. if the receiving water salinity is greater _NEW_LINE_              than or equal to 1,000 mg/l, then saltwater organisms shall be used. if the
8	salinity	2737	2745	82	       iwc at low flow is greater than or equal to one percent and the receiving _NEW_LINE_              water salinity is greater than or equal to 1,000 mg/l, the permittee shall _NEW_LINE_              perform short-term chronic
3	nh3	991	994	100	table attached) _NEW_LINE_  _NEW_LINE_ 2.     cbodu = 2.0 mg/l _NEW_LINE_  _NEW_LINE_ 3.     cbod5 = 1.33 mg/l _NEW_LINE_  _NEW_LINE_ 4.     nbodu = 0.5 mg/l _NEW_LINE_  _NEW_LINE_ 5.     nh3-n = 0.10 mg/l _NEW_LINE_  _NEW_LINE_ k.     photosynthesis / respiration _NEW_LINE_  _NEW_LINE_ 1.     input values for p and r (mg/l/day) can 
8	chlorine	2222	2230	102	luent chlorine concentration in ug/l _NEW_LINE_ qe     = daily average effluent flow in cfs _NEW_LINE_ ch     = headwater chlorine concentration (usually 0.0 ug/l) _NEW_LINE_ qh     = headwater flow (7q10) in cfs _NEW_LINE_ ct     = chlorine standard i
2	ph	1622	1624	103	am waste _NEW_LINE_ concentration) must be known and the warm water target values used. stream temperature and _NEW_LINE_ ph after mixing must also be known or assumed. for empirical modeling a ph of 7.0 and a _NEW_LINE_ stream tempera
2	ph	1694	1696	103	sed. stream temperature and _NEW_LINE_ ph after mixing must also be known or assumed. for empirical modeling a ph of 7.0 and a _NEW_LINE_ stream temperature of 25oc are assumed limitations. once this information is known, al
7	ammonia	2154	2161	103	e effluent nh3 concentration in mg/l _NEW_LINE_ qe     = daily average effluent flow in cfs _NEW_LINE_ ch     = headwater ammonia concentration of 0.1 mg/l _NEW_LINE_ qh     = headwater flow (7q10) in cfs _NEW_LINE_ ct     = ammonia criteria in mg/l (
7	ammonia	2235	2242	103	ch     = headwater ammonia concentration of 0.1 mg/l _NEW_LINE_ qh     = headwater flow (7q10) in cfs _NEW_LINE_ ct     = ammonia criteria in mg/l (after mixing) _NEW_LINE_ qt     = total stream flow in cfs (after mixing) _NEW_LINE_  _NEW_LINE_                  
8	salinity	1947	1955	109	ing, dilution water _NEW_LINE_ shall consist of synthetic seawater or hyper-saline brine combined to achieve a salinity of 20 _NEW_LINE_ parts per thousand according to short-term methods for estimating the chronic toxicity of _NEW_LINE_ eff
8	salinity	263	271	112	ing, dilution water shall _NEW_LINE_ consist of synthetic seawater or hyper-saline brine combined to achieve a salinity of 20 parts per _NEW_LINE_ thousand according to methods for measuring the acute toxicity of effluents and rec
8	salinity	2342	2350	113	ing, _NEW_LINE_ dilution water shall consist of synthetic seawater or hyper-saline brine combined to achieve a _NEW_LINE_ salinity of 20 parts per thousand according to methods for measuring the acute toxicity of _NEW_LINE_ effluents and rec
8	salinity	3180	3188	114	ing, dilution water shall _NEW_LINE_ consist of synthetic seawater or hyper-saline brine combined to achieve a salinity of 20 parts _NEW_LINE_ per thousand according to short-term methods for estimating the chronic toxicity of eff
9	chlorides	535	544	160	lowing concentrations at any time: _NEW_LINE_  _NEW_LINE_         from mississippi-tennessee border to vicksburg _NEW_LINE_  _NEW_LINE_         chlorides                                  60 mg/l _NEW_LINE_         sulfates                                  150 mg/l
8	sulfates	594	602	160	i-tennessee border to vicksburg _NEW_LINE_  _NEW_LINE_         chlorides                                  60 mg/l _NEW_LINE_         sulfates                                  150 mg/l _NEW_LINE_         tds                                       425 mg/
3	tds	653	656	160	                         60 mg/l _NEW_LINE_         sulfates                                  150 mg/l _NEW_LINE_         tds                                       425 mg/l _NEW_LINE_  _NEW_LINE_         from vicksburg south to the mississippi-lou
9	chlorides	779	788	160	                425 mg/l _NEW_LINE_  _NEW_LINE_         from vicksburg south to the mississippi-louisiana border _NEW_LINE_  _NEW_LINE_         chlorides                                  75 mg/l _NEW_LINE_         sulfates                                  120 mg/l
8	sulfates	838	846	160	he mississippi-louisiana border _NEW_LINE_  _NEW_LINE_         chlorides                                  75 mg/l _NEW_LINE_         sulfates                                  120 mg/l _NEW_LINE_         tds                                       400 mg/
3	tds	897	900	160	                         75 mg/l _NEW_LINE_         sulfates                                  120 mg/l _NEW_LINE_         tds                                       400 mg/l _NEW_LINE_  _NEW_LINE_ h.   mixing zones: it is recognized that limited ar
8	salinity	1694	1702	162	are of different _NEW_LINE_      densities. the density difference may be caused by variations of temperature, salinity, _NEW_LINE_      or concentrations of other dissolved substances within the water at different depths. _NEW_LINE_  _NEW_LINE_ (19) t
2	ph	1706	1708	164	from the water surface if the epilimnion depth is greater than 10 _NEW_LINE_                      feet. _NEW_LINE_  _NEW_LINE_ d.    ph: the normal ph of the waters shall be 6.0 to 9.0. the discharge of waters or _NEW_LINE_       wastewaters shou
2	ph	1721	1723	164	surface if the epilimnion depth is greater than 10 _NEW_LINE_                      feet. _NEW_LINE_  _NEW_LINE_ d.    ph: the normal ph of the waters shall be 6.0 to 9.0. the discharge of waters or _NEW_LINE_       wastewaters should not cause th
2	ph	2216	2218	164	eater ph change. in black water streams and in those _NEW_LINE_       watersheds with highly acidic soils, the ph may be lower than 6.0 due to natural _NEW_LINE_       conditions. _NEW_LINE_                                             
2	ph	1059	1061	172	ased on a ph dependent equation as found in quality _NEW_LINE_     criteria for water. values listed are for a ph of 7.0 s.u. _NEW_LINE_ d   site specific criteria for mississippi sound. _NEW_LINE_ e   parameter subject to water effect
6	aldrin	22	28	173	 _NEW_LINE_  _NEW_LINE_ acute: _NEW_LINE_  _NEW_LINE_ aldrin 3.0 μg/l _NEW_LINE_ 
9	ammonia f	38	47	173	 3.0 μg/l _NEW_LINE_ ammonia f _NEW_LINE_ arsenic (
7	arsenic	48	55	173	ammonia f _NEW_LINE_ arsenic (iii), to
7	arsenic	83	90	173	μg/l _NEW_LINE_ ammonia f _NEW_LINE_ arsenic (iii), total dissolved 340 _NEW_LINE_ arsenic, total dissolved _NEW_LINE_ cadmium, total dissolved 1.03 _NEW_LINE_ ch
7	cadmium	108	115	173	ter: _NEW_LINE_  _NEW_LINE_ acute: _NEW_LINE_  _NEW_LINE_ aldrin 3.0 μg/l _NEW_LINE_ ammonia f _NEW_LINE_ arsenic (iii), total dissolved 340 _NEW_LINE_ arsenic, total dissolved _NEW_LINE_ cadmium, total dissolved 1.03 _NEW_LINE_ chlordane 2.4 _NEW_LINE_ chlorine 19 _NEW_LINE_ chromium (hex), total dissolved 16 _NEW_LINE_ chromium (iii), 
9	chlordane	138	147	173	ammonia f _NEW_LINE_ arsenic (iii), total dissolved 340 _NEW_LINE_ arsenic, total dissolved _NEW_LINE_ cadmium, total dissolved 1.03 _NEW_LINE_ chlordane 2.4 _NEW_LINE_ chlorine 19 _NEW_LINE_ chromium (hex), total dissolved 16 _NEW_LINE_ chromium (iii), total dissolved 323 _NEW_LINE_ copper, tota
8	chlorine	152	160	173	nic (iii), total dissolved 340 _NEW_LINE_ arsenic, total dissolved _NEW_LINE_ cadmium, total dissolved 1.03 _NEW_LINE_ chlordane 2.4 _NEW_LINE_ chlorine 19 _NEW_LINE_ chromium (hex), total dissolved 16 _NEW_LINE_ chromium (iii), total dissolved 323 _NEW_LINE_ copper, total dissolved 7
8	chromium	164	172	173	otal dissolved 340 _NEW_LINE_ arsenic, total dissolved _NEW_LINE_ cadmium, total dissolved 1.03 _NEW_LINE_ chlordane 2.4 _NEW_LINE_ chlorine 19 _NEW_LINE_ chromium (hex), total dissolved 16 _NEW_LINE_ chromium (iii), total dissolved 323 _NEW_LINE_ copper, total dissolved 7.0 _NEW_LINE_ cyanide 2
8	chromium	199	207	173	issolved _NEW_LINE_ cadmium, total dissolved 1.03 _NEW_LINE_ chlordane 2.4 _NEW_LINE_ chlorine 19 _NEW_LINE_ chromium (hex), total dissolved 16 _NEW_LINE_ chromium (iii), total dissolved 323 _NEW_LINE_ copper, total dissolved 7.0 _NEW_LINE_ cyanide 22.0 _NEW_LINE_ 4,4 ddt 1.1 _NEW_LINE_ dieldrin 0.24 _NEW_LINE_ 2,3,7
6	copper	235	241	173	03 _NEW_LINE_ chlordane 2.4 _NEW_LINE_ chlorine 19 _NEW_LINE_ chromium (hex), total dissolved 16 _NEW_LINE_ chromium (iii), total dissolved 323 _NEW_LINE_ copper, total dissolved 7.0 _NEW_LINE_ cyanide 22.0 _NEW_LINE_ 4,4 ddt 1.1 _NEW_LINE_ dieldrin 0.24 _NEW_LINE_ 2,3,7,8 tcdd (dioxin) _NEW_LINE_ alpha-endosulfan 
7	cyanide	263	270	173	 _NEW_LINE_ chromium (hex), total dissolved 16 _NEW_LINE_ chromium (iii), total dissolved 323 _NEW_LINE_ copper, total dissolved 7.0 _NEW_LINE_ cyanide 22.0 _NEW_LINE_ 4,4 ddt 1.1 _NEW_LINE_ dieldrin 0.24 _NEW_LINE_ 2,3,7,8 tcdd (dioxin) _NEW_LINE_ alpha-endosulfan 0.22 _NEW_LINE_ beta-endosulfan 0.22 _NEW_LINE_ end
7	4,4 ddt	276	283	173	x), total dissolved 16 _NEW_LINE_ chromium (iii), total dissolved 323 _NEW_LINE_ copper, total dissolved 7.0 _NEW_LINE_ cyanide 22.0 _NEW_LINE_ 4,4 ddt 1.1 _NEW_LINE_ dieldrin 0.24 _NEW_LINE_ 2,3,7,8 tcdd (dioxin) _NEW_LINE_ alpha-endosulfan 0.22 _NEW_LINE_ beta-endosulfan 0.22 _NEW_LINE_ endosulfan sulfa
8	dieldrin	288	296	173	ssolved 16 _NEW_LINE_ chromium (iii), total dissolved 323 _NEW_LINE_ copper, total dissolved 7.0 _NEW_LINE_ cyanide 22.0 _NEW_LINE_ 4,4 ddt 1.1 _NEW_LINE_ dieldrin 0.24 _NEW_LINE_ 2,3,7,8 tcdd (dioxin) _NEW_LINE_ alpha-endosulfan 0.22 _NEW_LINE_ beta-endosulfan 0.22 _NEW_LINE_ endosulfan sulfate _NEW_LINE_ endrin 0.0
12	2,3,7,8 tcdd	302	314	173	omium (iii), total dissolved 323 _NEW_LINE_ copper, total dissolved 7.0 _NEW_LINE_ cyanide 22.0 _NEW_LINE_ 4,4 ddt 1.1 _NEW_LINE_ dieldrin 0.24 _NEW_LINE_ 2,3,7,8 tcdd (dioxin) _NEW_LINE_ alpha-endosulfan 0.22 _NEW_LINE_ beta-endosulfan 0.22 _NEW_LINE_ endosulfan sulfate _NEW_LINE_ endrin 0.086 _NEW_LINE_ heptachlor 0.52
6	dioxin	316	322	173	otal dissolved 323 _NEW_LINE_ copper, total dissolved 7.0 _NEW_LINE_ cyanide 22.0 _NEW_LINE_ 4,4 ddt 1.1 _NEW_LINE_ dieldrin 0.24 _NEW_LINE_ 2,3,7,8 tcdd (dioxin) _NEW_LINE_ alpha-endosulfan 0.22 _NEW_LINE_ beta-endosulfan 0.22 _NEW_LINE_ endosulfan sulfate _NEW_LINE_ endrin 0.086 _NEW_LINE_ heptachlor 0.52 _NEW_LINE_  _NEW_LINE_  _NEW_LINE_ fresh
16	alpha-endosulfan	324	340	173	solved 323 _NEW_LINE_ copper, total dissolved 7.0 _NEW_LINE_ cyanide 22.0 _NEW_LINE_ 4,4 ddt 1.1 _NEW_LINE_ dieldrin 0.24 _NEW_LINE_ 2,3,7,8 tcdd (dioxin) _NEW_LINE_ alpha-endosulfan 0.22 _NEW_LINE_ beta-endosulfan 0.22 _NEW_LINE_ endosulfan sulfate _NEW_LINE_ endrin 0.086 _NEW_LINE_ heptachlor 0.52 _NEW_LINE_  _NEW_LINE_  _NEW_LINE_ fresh water: _NEW_LINE_  _NEW_LINE_ chronic: _NEW_LINE_ 
15	beta-endosulfan	346	361	173	al dissolved 7.0 _NEW_LINE_ cyanide 22.0 _NEW_LINE_ 4,4 ddt 1.1 _NEW_LINE_ dieldrin 0.24 _NEW_LINE_ 2,3,7,8 tcdd (dioxin) _NEW_LINE_ alpha-endosulfan 0.22 _NEW_LINE_ beta-endosulfan 0.22 _NEW_LINE_ endosulfan sulfate _NEW_LINE_ endrin 0.086 _NEW_LINE_ heptachlor 0.52 _NEW_LINE_  _NEW_LINE_  _NEW_LINE_ fresh water: _NEW_LINE_  _NEW_LINE_ chronic: _NEW_LINE_  _NEW_LINE_ aldrin _NEW_LINE_ ammonia _NEW_LINE_ arsen
10	endosulfan	367	377	173	ide 22.0 _NEW_LINE_ 4,4 ddt 1.1 _NEW_LINE_ dieldrin 0.24 _NEW_LINE_ 2,3,7,8 tcdd (dioxin) _NEW_LINE_ alpha-endosulfan 0.22 _NEW_LINE_ beta-endosulfan 0.22 _NEW_LINE_ endosulfan sulfate _NEW_LINE_ endrin 0.086 _NEW_LINE_ heptachlor 0.52 _NEW_LINE_  _NEW_LINE_  _NEW_LINE_ fresh water: _NEW_LINE_  _NEW_LINE_ chronic: _NEW_LINE_  _NEW_LINE_ aldrin _NEW_LINE_ ammonia _NEW_LINE_ arsenic (iii), total 
7	sulfate	378	385	173	4 ddt 1.1 _NEW_LINE_ dieldrin 0.24 _NEW_LINE_ 2,3,7,8 tcdd (dioxin) _NEW_LINE_ alpha-endosulfan 0.22 _NEW_LINE_ beta-endosulfan 0.22 _NEW_LINE_ endosulfan sulfate _NEW_LINE_ endrin 0.086 _NEW_LINE_ heptachlor 0.52 _NEW_LINE_  _NEW_LINE_  _NEW_LINE_ fresh water: _NEW_LINE_  _NEW_LINE_ chronic: _NEW_LINE_  _NEW_LINE_ aldrin _NEW_LINE_ ammonia _NEW_LINE_ arsenic (iii), total dissolve
6	endrin	386	392	173	1 _NEW_LINE_ dieldrin 0.24 _NEW_LINE_ 2,3,7,8 tcdd (dioxin) _NEW_LINE_ alpha-endosulfan 0.22 _NEW_LINE_ beta-endosulfan 0.22 _NEW_LINE_ endosulfan sulfate _NEW_LINE_ endrin 0.086 _NEW_LINE_ heptachlor 0.52 _NEW_LINE_  _NEW_LINE_  _NEW_LINE_ fresh water: _NEW_LINE_  _NEW_LINE_ chronic: _NEW_LINE_  _NEW_LINE_ aldrin _NEW_LINE_ ammonia _NEW_LINE_ arsenic (iii), total dissolved 150 _NEW_LINE_ a
10	heptachlor	399	409	173	24 _NEW_LINE_ 2,3,7,8 tcdd (dioxin) _NEW_LINE_ alpha-endosulfan 0.22 _NEW_LINE_ beta-endosulfan 0.22 _NEW_LINE_ endosulfan sulfate _NEW_LINE_ endrin 0.086 _NEW_LINE_ heptachlor 0.52 _NEW_LINE_  _NEW_LINE_  _NEW_LINE_ fresh water: _NEW_LINE_  _NEW_LINE_ chronic: _NEW_LINE_  _NEW_LINE_ aldrin _NEW_LINE_ ammonia _NEW_LINE_ arsenic (iii), total dissolved 150 _NEW_LINE_ arsenic, total dis
6	aldrin	441	447	173	0.22 _NEW_LINE_ beta-endosulfan 0.22 _NEW_LINE_ endosulfan sulfate _NEW_LINE_ endrin 0.086 _NEW_LINE_ heptachlor 0.52 _NEW_LINE_  _NEW_LINE_  _NEW_LINE_ fresh water: _NEW_LINE_  _NEW_LINE_ chronic: _NEW_LINE_  _NEW_LINE_ aldrin _NEW_LINE_ ammonia _NEW_LINE_ arsenic (iii), total dissolved 150 _NEW_LINE_ arsenic, total dissolved _NEW_LINE_ cadmium, total dissolved 0.15 _NEW_LINE_ c
7	ammonia	448	455	173	ta-endosulfan 0.22 _NEW_LINE_ endosulfan sulfate _NEW_LINE_ endrin 0.086 _NEW_LINE_ heptachlor 0.52 _NEW_LINE_  _NEW_LINE_  _NEW_LINE_ fresh water: _NEW_LINE_  _NEW_LINE_ chronic: _NEW_LINE_  _NEW_LINE_ aldrin _NEW_LINE_ ammonia _NEW_LINE_ arsenic (iii), total dissolved 150 _NEW_LINE_ arsenic, total dissolved _NEW_LINE_ cadmium, total dissolved 0.15 _NEW_LINE_ chlordane
7	arsenic	456	463	173	ulfan 0.22 _NEW_LINE_ endosulfan sulfate _NEW_LINE_ endrin 0.086 _NEW_LINE_ heptachlor 0.52 _NEW_LINE_  _NEW_LINE_  _NEW_LINE_ fresh water: _NEW_LINE_  _NEW_LINE_ chronic: _NEW_LINE_  _NEW_LINE_ aldrin _NEW_LINE_ ammonia _NEW_LINE_ arsenic (iii), total dissolved 150 _NEW_LINE_ arsenic, total dissolved _NEW_LINE_ cadmium, total dissolved 0.15 _NEW_LINE_ chlordane 0.0043 _NEW_LINE_ 
7	arsenic	491	498	173	n 0.086 _NEW_LINE_ heptachlor 0.52 _NEW_LINE_  _NEW_LINE_  _NEW_LINE_ fresh water: _NEW_LINE_  _NEW_LINE_ chronic: _NEW_LINE_  _NEW_LINE_ aldrin _NEW_LINE_ ammonia _NEW_LINE_ arsenic (iii), total dissolved 150 _NEW_LINE_ arsenic, total dissolved _NEW_LINE_ cadmium, total dissolved 0.15 _NEW_LINE_ chlordane 0.0043 _NEW_LINE_ chlorine 11 _NEW_LINE_ chromium (hex), total d
7	cadmium	516	523	173	 _NEW_LINE_ fresh water: _NEW_LINE_  _NEW_LINE_ chronic: _NEW_LINE_  _NEW_LINE_ aldrin _NEW_LINE_ ammonia _NEW_LINE_ arsenic (iii), total dissolved 150 _NEW_LINE_ arsenic, total dissolved _NEW_LINE_ cadmium, total dissolved 0.15 _NEW_LINE_ chlordane 0.0043 _NEW_LINE_ chlorine 11 _NEW_LINE_ chromium (hex), total dissolved 11 _NEW_LINE_ chromium (iii
9	chlordane	546	555	173	n _NEW_LINE_ ammonia _NEW_LINE_ arsenic (iii), total dissolved 150 _NEW_LINE_ arsenic, total dissolved _NEW_LINE_ cadmium, total dissolved 0.15 _NEW_LINE_ chlordane 0.0043 _NEW_LINE_ chlorine 11 _NEW_LINE_ chromium (hex), total dissolved 11 _NEW_LINE_ chromium (iii), total dissolved 42 _NEW_LINE_ copper, to
8	chlorine	563	571	173	 (iii), total dissolved 150 _NEW_LINE_ arsenic, total dissolved _NEW_LINE_ cadmium, total dissolved 0.15 _NEW_LINE_ chlordane 0.0043 _NEW_LINE_ chlorine 11 _NEW_LINE_ chromium (hex), total dissolved 11 _NEW_LINE_ chromium (iii), total dissolved 42 _NEW_LINE_ copper, total dissolved 5.
8	chromium	575	583	173	l dissolved 150 _NEW_LINE_ arsenic, total dissolved _NEW_LINE_ cadmium, total dissolved 0.15 _NEW_LINE_ chlordane 0.0043 _NEW_LINE_ chlorine 11 _NEW_LINE_ chromium (hex), total dissolved 11 _NEW_LINE_ chromium (iii), total dissolved 42 _NEW_LINE_ copper, total dissolved 5.0 _NEW_LINE_ cyanide 5.
8	chromium	610	618	173	olved _NEW_LINE_ cadmium, total dissolved 0.15 _NEW_LINE_ chlordane 0.0043 _NEW_LINE_ chlorine 11 _NEW_LINE_ chromium (hex), total dissolved 11 _NEW_LINE_ chromium (iii), total dissolved 42 _NEW_LINE_ copper, total dissolved 5.0 _NEW_LINE_ cyanide 5.2 _NEW_LINE_ 4,4 ddt 0.001 _NEW_LINE_ dieldrin 0.056 _NEW_LINE_ 2,3,
6	copper	645	651	173	 _NEW_LINE_ chlordane 0.0043 _NEW_LINE_ chlorine 11 _NEW_LINE_ chromium (hex), total dissolved 11 _NEW_LINE_ chromium (iii), total dissolved 42 _NEW_LINE_ copper, total dissolved 5.0 _NEW_LINE_ cyanide 5.2 _NEW_LINE_ 4,4 ddt 0.001 _NEW_LINE_ dieldrin 0.056 _NEW_LINE_ 2,3,7,8 tcdd (dioxin) _NEW_LINE_ alpha-endosulfa
7	cyanide	673	680	173	1 _NEW_LINE_ chromium (hex), total dissolved 11 _NEW_LINE_ chromium (iii), total dissolved 42 _NEW_LINE_ copper, total dissolved 5.0 _NEW_LINE_ cyanide 5.2 _NEW_LINE_ 4,4 ddt 0.001 _NEW_LINE_ dieldrin 0.056 _NEW_LINE_ 2,3,7,8 tcdd (dioxin) _NEW_LINE_ alpha-endosulfan 0.056 _NEW_LINE_ beta-endosulfan 0.056
7	4,4 ddt	685	692	173	hex), total dissolved 11 _NEW_LINE_ chromium (iii), total dissolved 42 _NEW_LINE_ copper, total dissolved 5.0 _NEW_LINE_ cyanide 5.2 _NEW_LINE_ 4,4 ddt 0.001 _NEW_LINE_ dieldrin 0.056 _NEW_LINE_ 2,3,7,8 tcdd (dioxin) _NEW_LINE_ alpha-endosulfan 0.056 _NEW_LINE_ beta-endosulfan 0.056 _NEW_LINE_ endosulfan 
8	dieldrin	699	707	173	ssolved 11 _NEW_LINE_ chromium (iii), total dissolved 42 _NEW_LINE_ copper, total dissolved 5.0 _NEW_LINE_ cyanide 5.2 _NEW_LINE_ 4,4 ddt 0.001 _NEW_LINE_ dieldrin 0.056 _NEW_LINE_ 2,3,7,8 tcdd (dioxin) _NEW_LINE_ alpha-endosulfan 0.056 _NEW_LINE_ beta-endosulfan 0.056 _NEW_LINE_ endosulfan sulfate _NEW_LINE_ endrin 
12	2,3,7,8 tcdd	714	726	173	mium (iii), total dissolved 42 _NEW_LINE_ copper, total dissolved 5.0 _NEW_LINE_ cyanide 5.2 _NEW_LINE_ 4,4 ddt 0.001 _NEW_LINE_ dieldrin 0.056 _NEW_LINE_ 2,3,7,8 tcdd (dioxin) _NEW_LINE_ alpha-endosulfan 0.056 _NEW_LINE_ beta-endosulfan 0.056 _NEW_LINE_ endosulfan sulfate _NEW_LINE_ endrin 0.036 _NEW_LINE_ heptachlor 0.
6	dioxin	728	734	173	tal dissolved 42 _NEW_LINE_ copper, total dissolved 5.0 _NEW_LINE_ cyanide 5.2 _NEW_LINE_ 4,4 ddt 0.001 _NEW_LINE_ dieldrin 0.056 _NEW_LINE_ 2,3,7,8 tcdd (dioxin) _NEW_LINE_ alpha-endosulfan 0.056 _NEW_LINE_ beta-endosulfan 0.056 _NEW_LINE_ endosulfan sulfate _NEW_LINE_ endrin 0.036 _NEW_LINE_ heptachlor 0.0038 _NEW_LINE_  _NEW_LINE_  _NEW_LINE_  _NEW_LINE_ 
16	alpha-endosulfan	736	752	173	olved 42 _NEW_LINE_ copper, total dissolved 5.0 _NEW_LINE_ cyanide 5.2 _NEW_LINE_ 4,4 ddt 0.001 _NEW_LINE_ dieldrin 0.056 _NEW_LINE_ 2,3,7,8 tcdd (dioxin) _NEW_LINE_ alpha-endosulfan 0.056 _NEW_LINE_ beta-endosulfan 0.056 _NEW_LINE_ endosulfan sulfate _NEW_LINE_ endrin 0.036 _NEW_LINE_ heptachlor 0.0038 _NEW_LINE_  _NEW_LINE_  _NEW_LINE_  _NEW_LINE_ salt water: _NEW_LINE_ acute:
15	beta-endosulfan	759	774	173	dissolved 5.0 _NEW_LINE_ cyanide 5.2 _NEW_LINE_ 4,4 ddt 0.001 _NEW_LINE_ dieldrin 0.056 _NEW_LINE_ 2,3,7,8 tcdd (dioxin) _NEW_LINE_ alpha-endosulfan 0.056 _NEW_LINE_ beta-endosulfan 0.056 _NEW_LINE_ endosulfan sulfate _NEW_LINE_ endrin 0.036 _NEW_LINE_ heptachlor 0.0038 _NEW_LINE_  _NEW_LINE_  _NEW_LINE_  _NEW_LINE_ salt water: _NEW_LINE_ acute: _NEW_LINE_  _NEW_LINE_ aldrin 1.3 _NEW_LINE_ ammonia _NEW_LINE_ a
10	endosulfan	781	791	173	5.2 _NEW_LINE_ 4,4 ddt 0.001 _NEW_LINE_ dieldrin 0.056 _NEW_LINE_ 2,3,7,8 tcdd (dioxin) _NEW_LINE_ alpha-endosulfan 0.056 _NEW_LINE_ beta-endosulfan 0.056 _NEW_LINE_ endosulfan sulfate _NEW_LINE_ endrin 0.036 _NEW_LINE_ heptachlor 0.0038 _NEW_LINE_  _NEW_LINE_  _NEW_LINE_  _NEW_LINE_ salt water: _NEW_LINE_ acute: _NEW_LINE_  _NEW_LINE_ aldrin 1.3 _NEW_LINE_ ammonia _NEW_LINE_ arsenic (iii), tot
7	sulfate	792	799	173	 0.001 _NEW_LINE_ dieldrin 0.056 _NEW_LINE_ 2,3,7,8 tcdd (dioxin) _NEW_LINE_ alpha-endosulfan 0.056 _NEW_LINE_ beta-endosulfan 0.056 _NEW_LINE_ endosulfan sulfate _NEW_LINE_ endrin 0.036 _NEW_LINE_ heptachlor 0.0038 _NEW_LINE_  _NEW_LINE_  _NEW_LINE_  _NEW_LINE_ salt water: _NEW_LINE_ acute: _NEW_LINE_  _NEW_LINE_ aldrin 1.3 _NEW_LINE_ ammonia _NEW_LINE_ arsenic (iii), total disso
6	endrin	800	806	173	ieldrin 0.056 _NEW_LINE_ 2,3,7,8 tcdd (dioxin) _NEW_LINE_ alpha-endosulfan 0.056 _NEW_LINE_ beta-endosulfan 0.056 _NEW_LINE_ endosulfan sulfate _NEW_LINE_ endrin 0.036 _NEW_LINE_ heptachlor 0.0038 _NEW_LINE_  _NEW_LINE_  _NEW_LINE_  _NEW_LINE_ salt water: _NEW_LINE_ acute: _NEW_LINE_  _NEW_LINE_ aldrin 1.3 _NEW_LINE_ ammonia _NEW_LINE_ arsenic (iii), total dissolved 69
10	heptachlor	813	823	173	 _NEW_LINE_ 2,3,7,8 tcdd (dioxin) _NEW_LINE_ alpha-endosulfan 0.056 _NEW_LINE_ beta-endosulfan 0.056 _NEW_LINE_ endosulfan sulfate _NEW_LINE_ endrin 0.036 _NEW_LINE_ heptachlor 0.0038 _NEW_LINE_  _NEW_LINE_  _NEW_LINE_  _NEW_LINE_ salt water: _NEW_LINE_ acute: _NEW_LINE_  _NEW_LINE_ aldrin 1.3 _NEW_LINE_ ammonia _NEW_LINE_ arsenic (iii), total dissolved 69 _NEW_LINE_ arsenic, total d
6	aldrin	854	860	173	.056 _NEW_LINE_ beta-endosulfan 0.056 _NEW_LINE_ endosulfan sulfate _NEW_LINE_ endrin 0.036 _NEW_LINE_ heptachlor 0.0038 _NEW_LINE_  _NEW_LINE_  _NEW_LINE_  _NEW_LINE_ salt water: _NEW_LINE_ acute: _NEW_LINE_  _NEW_LINE_ aldrin 1.3 _NEW_LINE_ ammonia _NEW_LINE_ arsenic (iii), total dissolved 69 _NEW_LINE_ arsenic, total dissolved _NEW_LINE_ cadmium, total dissolved 40 _NEW_LINE_ 
7	ammonia	865	872	173	ndosulfan 0.056 _NEW_LINE_ endosulfan sulfate _NEW_LINE_ endrin 0.036 _NEW_LINE_ heptachlor 0.0038 _NEW_LINE_  _NEW_LINE_  _NEW_LINE_  _NEW_LINE_ salt water: _NEW_LINE_ acute: _NEW_LINE_  _NEW_LINE_ aldrin 1.3 _NEW_LINE_ ammonia _NEW_LINE_ arsenic (iii), total dissolved 69 _NEW_LINE_ arsenic, total dissolved _NEW_LINE_ cadmium, total dissolved 40 _NEW_LINE_ chlordane 0.
7	arsenic	873	880	173	n 0.056 _NEW_LINE_ endosulfan sulfate _NEW_LINE_ endrin 0.036 _NEW_LINE_ heptachlor 0.0038 _NEW_LINE_  _NEW_LINE_  _NEW_LINE_  _NEW_LINE_ salt water: _NEW_LINE_ acute: _NEW_LINE_  _NEW_LINE_ aldrin 1.3 _NEW_LINE_ ammonia _NEW_LINE_ arsenic (iii), total dissolved 69 _NEW_LINE_ arsenic, total dissolved _NEW_LINE_ cadmium, total dissolved 40 _NEW_LINE_ chlordane 0.09 _NEW_LINE_ chlor
7	arsenic	907	914	173	0.036 _NEW_LINE_ heptachlor 0.0038 _NEW_LINE_  _NEW_LINE_  _NEW_LINE_  _NEW_LINE_ salt water: _NEW_LINE_ acute: _NEW_LINE_  _NEW_LINE_ aldrin 1.3 _NEW_LINE_ ammonia _NEW_LINE_ arsenic (iii), total dissolved 69 _NEW_LINE_ arsenic, total dissolved _NEW_LINE_ cadmium, total dissolved 40 _NEW_LINE_ chlordane 0.09 _NEW_LINE_ chlorine 13 _NEW_LINE_ chromium (hex), total disso
7	cadmium	932	939	173	 _NEW_LINE_  _NEW_LINE_ salt water: _NEW_LINE_ acute: _NEW_LINE_  _NEW_LINE_ aldrin 1.3 _NEW_LINE_ ammonia _NEW_LINE_ arsenic (iii), total dissolved 69 _NEW_LINE_ arsenic, total dissolved _NEW_LINE_ cadmium, total dissolved 40 _NEW_LINE_ chlordane 0.09 _NEW_LINE_ chlorine 13 _NEW_LINE_ chromium (hex), total dissolved 1100 _NEW_LINE_ chromium (iii),
9	chlordane	960	969	173	 1.3 _NEW_LINE_ ammonia _NEW_LINE_ arsenic (iii), total dissolved 69 _NEW_LINE_ arsenic, total dissolved _NEW_LINE_ cadmium, total dissolved 40 _NEW_LINE_ chlordane 0.09 _NEW_LINE_ chlorine 13 _NEW_LINE_ chromium (hex), total dissolved 1100 _NEW_LINE_ chromium (iii), total dissolved _NEW_LINE_ copper, total
8	chlorine	975	983	173	senic (iii), total dissolved 69 _NEW_LINE_ arsenic, total dissolved _NEW_LINE_ cadmium, total dissolved 40 _NEW_LINE_ chlordane 0.09 _NEW_LINE_ chlorine 13 _NEW_LINE_ chromium (hex), total dissolved 1100 _NEW_LINE_ chromium (iii), total dissolved _NEW_LINE_ copper, total dissolved 4.8
8	chromium	987	995	173	 total dissolved 69 _NEW_LINE_ arsenic, total dissolved _NEW_LINE_ cadmium, total dissolved 40 _NEW_LINE_ chlordane 0.09 _NEW_LINE_ chlorine 13 _NEW_LINE_ chromium (hex), total dissolved 1100 _NEW_LINE_ chromium (iii), total dissolved _NEW_LINE_ copper, total dissolved 4.8 _NEW_LINE_ cyanide 1.0
8	chromium	1024	1032	173	ssolved _NEW_LINE_ cadmium, total dissolved 40 _NEW_LINE_ chlordane 0.09 _NEW_LINE_ chlorine 13 _NEW_LINE_ chromium (hex), total dissolved 1100 _NEW_LINE_ chromium (iii), total dissolved _NEW_LINE_ copper, total dissolved 4.8 _NEW_LINE_ cyanide 1.0 _NEW_LINE_ 4,4 ddt 0.13 _NEW_LINE_ dieldrin 0.71 _NEW_LINE_ 2,3,7,8 t
6	copper	1056	1062	173	 40 _NEW_LINE_ chlordane 0.09 _NEW_LINE_ chlorine 13 _NEW_LINE_ chromium (hex), total dissolved 1100 _NEW_LINE_ chromium (iii), total dissolved _NEW_LINE_ copper, total dissolved 4.8 _NEW_LINE_ cyanide 1.0 _NEW_LINE_ 4,4 ddt 0.13 _NEW_LINE_ dieldrin 0.71 _NEW_LINE_ 2,3,7,8 tcdd (dioxin) _NEW_LINE_ alpha-endosulfan 
7	cyanide	1084	1091	173	13 _NEW_LINE_ chromium (hex), total dissolved 1100 _NEW_LINE_ chromium (iii), total dissolved _NEW_LINE_ copper, total dissolved 4.8 _NEW_LINE_ cyanide 1.0 _NEW_LINE_ 4,4 ddt 0.13 _NEW_LINE_ dieldrin 0.71 _NEW_LINE_ 2,3,7,8 tcdd (dioxin) _NEW_LINE_ alpha-endosulfan 0.034 _NEW_LINE_ beta-endosulfan 0.034 _NEW_LINE_ e
7	4,4 ddt	1096	1103	173	(hex), total dissolved 1100 _NEW_LINE_ chromium (iii), total dissolved _NEW_LINE_ copper, total dissolved 4.8 _NEW_LINE_ cyanide 1.0 _NEW_LINE_ 4,4 ddt 0.13 _NEW_LINE_ dieldrin 0.71 _NEW_LINE_ 2,3,7,8 tcdd (dioxin) _NEW_LINE_ alpha-endosulfan 0.034 _NEW_LINE_ beta-endosulfan 0.034 _NEW_LINE_ endosulfan su
8	dieldrin	1109	1117	173	dissolved 1100 _NEW_LINE_ chromium (iii), total dissolved _NEW_LINE_ copper, total dissolved 4.8 _NEW_LINE_ cyanide 1.0 _NEW_LINE_ 4,4 ddt 0.13 _NEW_LINE_ dieldrin 0.71 _NEW_LINE_ 2,3,7,8 tcdd (dioxin) _NEW_LINE_ alpha-endosulfan 0.034 _NEW_LINE_ beta-endosulfan 0.034 _NEW_LINE_ endosulfan sulfate _NEW_LINE_ endrin 0
12	2,3,7,8 tcdd	1123	1135	173	 _NEW_LINE_ chromium (iii), total dissolved _NEW_LINE_ copper, total dissolved 4.8 _NEW_LINE_ cyanide 1.0 _NEW_LINE_ 4,4 ddt 0.13 _NEW_LINE_ dieldrin 0.71 _NEW_LINE_ 2,3,7,8 tcdd (dioxin) _NEW_LINE_ alpha-endosulfan 0.034 _NEW_LINE_ beta-endosulfan 0.034 _NEW_LINE_ endosulfan sulfate _NEW_LINE_ endrin 0.037 _NEW_LINE_ heptachlor 0.
6	dioxin	1137	1143	173	), total dissolved _NEW_LINE_ copper, total dissolved 4.8 _NEW_LINE_ cyanide 1.0 _NEW_LINE_ 4,4 ddt 0.13 _NEW_LINE_ dieldrin 0.71 _NEW_LINE_ 2,3,7,8 tcdd (dioxin) _NEW_LINE_ alpha-endosulfan 0.034 _NEW_LINE_ beta-endosulfan 0.034 _NEW_LINE_ endosulfan sulfate _NEW_LINE_ endrin 0.037 _NEW_LINE_ heptachlor 0.053 _NEW_LINE_  _NEW_LINE_ sal
16	alpha-endosulfan	1145	1161	173	 dissolved _NEW_LINE_ copper, total dissolved 4.8 _NEW_LINE_ cyanide 1.0 _NEW_LINE_ 4,4 ddt 0.13 _NEW_LINE_ dieldrin 0.71 _NEW_LINE_ 2,3,7,8 tcdd (dioxin) _NEW_LINE_ alpha-endosulfan 0.034 _NEW_LINE_ beta-endosulfan 0.034 _NEW_LINE_ endosulfan sulfate _NEW_LINE_ endrin 0.037 _NEW_LINE_ heptachlor 0.053 _NEW_LINE_  _NEW_LINE_ salt water: _NEW_LINE_ chronic: _NEW_LINE_ 
15	beta-endosulfan	1168	1183	173	l dissolved 4.8 _NEW_LINE_ cyanide 1.0 _NEW_LINE_ 4,4 ddt 0.13 _NEW_LINE_ dieldrin 0.71 _NEW_LINE_ 2,3,7,8 tcdd (dioxin) _NEW_LINE_ alpha-endosulfan 0.034 _NEW_LINE_ beta-endosulfan 0.034 _NEW_LINE_ endosulfan sulfate _NEW_LINE_ endrin 0.037 _NEW_LINE_ heptachlor 0.053 _NEW_LINE_  _NEW_LINE_ salt water: _NEW_LINE_ chronic: _NEW_LINE_  _NEW_LINE_ aldrin _NEW_LINE_ ammonia _NEW_LINE_ arseni
10	endosulfan	1190	1200	173	e 1.0 _NEW_LINE_ 4,4 ddt 0.13 _NEW_LINE_ dieldrin 0.71 _NEW_LINE_ 2,3,7,8 tcdd (dioxin) _NEW_LINE_ alpha-endosulfan 0.034 _NEW_LINE_ beta-endosulfan 0.034 _NEW_LINE_ endosulfan sulfate _NEW_LINE_ endrin 0.037 _NEW_LINE_ heptachlor 0.053 _NEW_LINE_  _NEW_LINE_ salt water: _NEW_LINE_ chronic: _NEW_LINE_  _NEW_LINE_ aldrin _NEW_LINE_ ammonia _NEW_LINE_ arsenic (iii), total di
7	sulfate	1201	1208	173	dt 0.13 _NEW_LINE_ dieldrin 0.71 _NEW_LINE_ 2,3,7,8 tcdd (dioxin) _NEW_LINE_ alpha-endosulfan 0.034 _NEW_LINE_ beta-endosulfan 0.034 _NEW_LINE_ endosulfan sulfate _NEW_LINE_ endrin 0.037 _NEW_LINE_ heptachlor 0.053 _NEW_LINE_  _NEW_LINE_ salt water: _NEW_LINE_ chronic: _NEW_LINE_  _NEW_LINE_ aldrin _NEW_LINE_ ammonia _NEW_LINE_ arsenic (iii), total dissolved 
6	endrin	1209	1215	173	dieldrin 0.71 _NEW_LINE_ 2,3,7,8 tcdd (dioxin) _NEW_LINE_ alpha-endosulfan 0.034 _NEW_LINE_ beta-endosulfan 0.034 _NEW_LINE_ endosulfan sulfate _NEW_LINE_ endrin 0.037 _NEW_LINE_ heptachlor 0.053 _NEW_LINE_  _NEW_LINE_ salt water: _NEW_LINE_ chronic: _NEW_LINE_  _NEW_LINE_ aldrin _NEW_LINE_ ammonia _NEW_LINE_ arsenic (iii), total dissolved 36 _NEW_LINE_ arse
10	heptachlor	1222	1232	173	 _NEW_LINE_ 2,3,7,8 tcdd (dioxin) _NEW_LINE_ alpha-endosulfan 0.034 _NEW_LINE_ beta-endosulfan 0.034 _NEW_LINE_ endosulfan sulfate _NEW_LINE_ endrin 0.037 _NEW_LINE_ heptachlor 0.053 _NEW_LINE_  _NEW_LINE_ salt water: _NEW_LINE_ chronic: _NEW_LINE_  _NEW_LINE_ aldrin _NEW_LINE_ ammonia _NEW_LINE_ arsenic (iii), total dissolved 36 _NEW_LINE_ arsenic, total dissol
6	aldrin	1262	1268	173	0.034 _NEW_LINE_ beta-endosulfan 0.034 _NEW_LINE_ endosulfan sulfate _NEW_LINE_ endrin 0.037 _NEW_LINE_ heptachlor 0.053 _NEW_LINE_  _NEW_LINE_ salt water: _NEW_LINE_ chronic: _NEW_LINE_  _NEW_LINE_ aldrin _NEW_LINE_ ammonia _NEW_LINE_ arsenic (iii), total dissolved 36 _NEW_LINE_ arsenic, total dissolved _NEW_LINE_ cadmium, total dissolved 8.8 _NEW_LINE_ chl
7	ammonia	1269	1276	173	eta-endosulfan 0.034 _NEW_LINE_ endosulfan sulfate _NEW_LINE_ endrin 0.037 _NEW_LINE_ heptachlor 0.053 _NEW_LINE_  _NEW_LINE_ salt water: _NEW_LINE_ chronic: _NEW_LINE_  _NEW_LINE_ aldrin _NEW_LINE_ ammonia _NEW_LINE_ arsenic (iii), total dissolved 36 _NEW_LINE_ arsenic, total dissolved _NEW_LINE_ cadmium, total dissolved 8.8 _NEW_LINE_ chlordane 0
7	arsenic	1277	1284	173	sulfan 0.034 _NEW_LINE_ endosulfan sulfate _NEW_LINE_ endrin 0.037 _NEW_LINE_ heptachlor 0.053 _NEW_LINE_  _NEW_LINE_ salt water: _NEW_LINE_ chronic: _NEW_LINE_  _NEW_LINE_ aldrin _NEW_LINE_ ammonia _NEW_LINE_ arsenic (iii), total dissolved 36 _NEW_LINE_ arsenic, total dissolved _NEW_LINE_ cadmium, total dissolved 8.8 _NEW_LINE_ chlordane 0.004 _NEW_LINE_ chl
7	arsenic	1311	1318	173	drin 0.037 _NEW_LINE_ heptachlor 0.053 _NEW_LINE_  _NEW_LINE_ salt water: _NEW_LINE_ chronic: _NEW_LINE_  _NEW_LINE_ aldrin _NEW_LINE_ ammonia _NEW_LINE_ arsenic (iii), total dissolved 36 _NEW_LINE_ arsenic, total dissolved _NEW_LINE_ cadmium, total dissolved 8.8 _NEW_LINE_ chlordane 0.004 _NEW_LINE_ chlorine 7.5 _NEW_LINE_ chromium (hex), total di
7	cadmium	1336	1343	173	53 _NEW_LINE_  _NEW_LINE_ salt water: _NEW_LINE_ chronic: _NEW_LINE_  _NEW_LINE_ aldrin _NEW_LINE_ ammonia _NEW_LINE_ arsenic (iii), total dissolved 36 _NEW_LINE_ arsenic, total dissolved _NEW_LINE_ cadmium, total dissolved 8.8 _NEW_LINE_ chlordane 0.004 _NEW_LINE_ chlorine 7.5 _NEW_LINE_ chromium (hex), total dissolved 50 _NEW_LINE_ chromium (iii)
9	chlordane	1365	1374	173	rin _NEW_LINE_ ammonia _NEW_LINE_ arsenic (iii), total dissolved 36 _NEW_LINE_ arsenic, total dissolved _NEW_LINE_ cadmium, total dissolved 8.8 _NEW_LINE_ chlordane 0.004 _NEW_LINE_ chlorine 7.5 _NEW_LINE_ chromium (hex), total dissolved 50 _NEW_LINE_ chromium (iii), total dissolved _NEW_LINE_ copper, total
8	chlorine	1381	1389	173	nic (iii), total dissolved 36 _NEW_LINE_ arsenic, total dissolved _NEW_LINE_ cadmium, total dissolved 8.8 _NEW_LINE_ chlordane 0.004 _NEW_LINE_ chlorine 7.5 _NEW_LINE_ chromium (hex), total dissolved 50 _NEW_LINE_ chromium (iii), total dissolved _NEW_LINE_ copper, total dissolved 3.1 _NEW_LINE_ 
8	chromium	1394	1402	173	tal dissolved 36 _NEW_LINE_ arsenic, total dissolved _NEW_LINE_ cadmium, total dissolved 8.8 _NEW_LINE_ chlordane 0.004 _NEW_LINE_ chlorine 7.5 _NEW_LINE_ chromium (hex), total dissolved 50 _NEW_LINE_ chromium (iii), total dissolved _NEW_LINE_ copper, total dissolved 3.1 _NEW_LINE_ cyanide 1.0 _NEW_LINE_ 4
8	chromium	1429	1437	173	solved _NEW_LINE_ cadmium, total dissolved 8.8 _NEW_LINE_ chlordane 0.004 _NEW_LINE_ chlorine 7.5 _NEW_LINE_ chromium (hex), total dissolved 50 _NEW_LINE_ chromium (iii), total dissolved _NEW_LINE_ copper, total dissolved 3.1 _NEW_LINE_ cyanide 1.0 _NEW_LINE_ 4,4 ddt 0.001 _NEW_LINE_ dieldrin 0.0019 _NEW_LINE_ 2,3,7,
6	copper	1461	1467	173	8.8 _NEW_LINE_ chlordane 0.004 _NEW_LINE_ chlorine 7.5 _NEW_LINE_ chromium (hex), total dissolved 50 _NEW_LINE_ chromium (iii), total dissolved _NEW_LINE_ copper, total dissolved 3.1 _NEW_LINE_ cyanide 1.0 _NEW_LINE_ 4,4 ddt 0.001 _NEW_LINE_ dieldrin 0.0019 _NEW_LINE_ 2,3,7,8 tcdd (dioxin) _NEW_LINE_ alpha-endosulf
7	cyanide	1489	1496	173	 7.5 _NEW_LINE_ chromium (hex), total dissolved 50 _NEW_LINE_ chromium (iii), total dissolved _NEW_LINE_ copper, total dissolved 3.1 _NEW_LINE_ cyanide 1.0 _NEW_LINE_ 4,4 ddt 0.001 _NEW_LINE_ dieldrin 0.0019 _NEW_LINE_ 2,3,7,8 tcdd (dioxin) _NEW_LINE_ alpha-endosulfan 0.0087 _NEW_LINE_ beta-endosulfan 0.0
7	4,4 ddt	1501	1508	173	m (hex), total dissolved 50 _NEW_LINE_ chromium (iii), total dissolved _NEW_LINE_ copper, total dissolved 3.1 _NEW_LINE_ cyanide 1.0 _NEW_LINE_ 4,4 ddt 0.001 _NEW_LINE_ dieldrin 0.0019 _NEW_LINE_ 2,3,7,8 tcdd (dioxin) _NEW_LINE_ alpha-endosulfan 0.0087 _NEW_LINE_ beta-endosulfan 0.0087 _NEW_LINE_ endosulf
8	dieldrin	1515	1523	173	 dissolved 50 _NEW_LINE_ chromium (iii), total dissolved _NEW_LINE_ copper, total dissolved 3.1 _NEW_LINE_ cyanide 1.0 _NEW_LINE_ 4,4 ddt 0.001 _NEW_LINE_ dieldrin 0.0019 _NEW_LINE_ 2,3,7,8 tcdd (dioxin) _NEW_LINE_ alpha-endosulfan 0.0087 _NEW_LINE_ beta-endosulfan 0.0087 _NEW_LINE_ endosulfan sulfate _NEW_LINE_ endr
12	2,3,7,8 tcdd	1531	1543	173	romium (iii), total dissolved _NEW_LINE_ copper, total dissolved 3.1 _NEW_LINE_ cyanide 1.0 _NEW_LINE_ 4,4 ddt 0.001 _NEW_LINE_ dieldrin 0.0019 _NEW_LINE_ 2,3,7,8 tcdd (dioxin) _NEW_LINE_ alpha-endosulfan 0.0087 _NEW_LINE_ beta-endosulfan 0.0087 _NEW_LINE_ endosulfan sulfate _NEW_LINE_ endrin 0.0023 _NEW_LINE_ heptachlor
6	dioxin	1545	1551	173	total dissolved _NEW_LINE_ copper, total dissolved 3.1 _NEW_LINE_ cyanide 1.0 _NEW_LINE_ 4,4 ddt 0.001 _NEW_LINE_ dieldrin 0.0019 _NEW_LINE_ 2,3,7,8 tcdd (dioxin) _NEW_LINE_ alpha-endosulfan 0.0087 _NEW_LINE_ beta-endosulfan 0.0087 _NEW_LINE_ endosulfan sulfate _NEW_LINE_ endrin 0.0023 _NEW_LINE_ heptachlor 0.0036 _NEW_LINE_ 
16	alpha-endosulfan	1553	1569	173	ssolved _NEW_LINE_ copper, total dissolved 3.1 _NEW_LINE_ cyanide 1.0 _NEW_LINE_ 4,4 ddt 0.001 _NEW_LINE_ dieldrin 0.0019 _NEW_LINE_ 2,3,7,8 tcdd (dioxin) _NEW_LINE_ alpha-endosulfan 0.0087 _NEW_LINE_ beta-endosulfan 0.0087 _NEW_LINE_ endosulfan sulfate _NEW_LINE_ endrin 0.0023 _NEW_LINE_ heptachlor 0.0036 _NEW_LINE_  _NEW_LINE_  _NEW_LINE_ human health: _NEW_LINE_ or
15	beta-endosulfan	1577	1592	173	ssolved 3.1 _NEW_LINE_ cyanide 1.0 _NEW_LINE_ 4,4 ddt 0.001 _NEW_LINE_ dieldrin 0.0019 _NEW_LINE_ 2,3,7,8 tcdd (dioxin) _NEW_LINE_ alpha-endosulfan 0.0087 _NEW_LINE_ beta-endosulfan 0.0087 _NEW_LINE_ endosulfan sulfate _NEW_LINE_ endrin 0.0023 _NEW_LINE_ heptachlor 0.0036 _NEW_LINE_  _NEW_LINE_  _NEW_LINE_ human health: _NEW_LINE_ organism only: _NEW_LINE_  _NEW_LINE_ aldrin 0.
10	endosulfan	1600	1610	173	 _NEW_LINE_ 4,4 ddt 0.001 _NEW_LINE_ dieldrin 0.0019 _NEW_LINE_ 2,3,7,8 tcdd (dioxin) _NEW_LINE_ alpha-endosulfan 0.0087 _NEW_LINE_ beta-endosulfan 0.0087 _NEW_LINE_ endosulfan sulfate _NEW_LINE_ endrin 0.0023 _NEW_LINE_ heptachlor 0.0036 _NEW_LINE_  _NEW_LINE_  _NEW_LINE_ human health: _NEW_LINE_ organism only: _NEW_LINE_  _NEW_LINE_ aldrin 0.000050 _NEW_LINE_ ammonia _NEW_LINE_ ars
7	sulfate	1611	1618	173	001 _NEW_LINE_ dieldrin 0.0019 _NEW_LINE_ 2,3,7,8 tcdd (dioxin) _NEW_LINE_ alpha-endosulfan 0.0087 _NEW_LINE_ beta-endosulfan 0.0087 _NEW_LINE_ endosulfan sulfate _NEW_LINE_ endrin 0.0023 _NEW_LINE_ heptachlor 0.0036 _NEW_LINE_  _NEW_LINE_  _NEW_LINE_ human health: _NEW_LINE_ organism only: _NEW_LINE_  _NEW_LINE_ aldrin 0.000050 _NEW_LINE_ ammonia _NEW_LINE_ arsenic (ii
6	endrin	1619	1625	173	drin 0.0019 _NEW_LINE_ 2,3,7,8 tcdd (dioxin) _NEW_LINE_ alpha-endosulfan 0.0087 _NEW_LINE_ beta-endosulfan 0.0087 _NEW_LINE_ endosulfan sulfate _NEW_LINE_ endrin 0.0023 _NEW_LINE_ heptachlor 0.0036 _NEW_LINE_  _NEW_LINE_  _NEW_LINE_ human health: _NEW_LINE_ organism only: _NEW_LINE_  _NEW_LINE_ aldrin 0.000050 _NEW_LINE_ ammonia _NEW_LINE_ arsenic (iii), tot
10	heptachlor	1633	1643	173	3,7,8 tcdd (dioxin) _NEW_LINE_ alpha-endosulfan 0.0087 _NEW_LINE_ beta-endosulfan 0.0087 _NEW_LINE_ endosulfan sulfate _NEW_LINE_ endrin 0.0023 _NEW_LINE_ heptachlor 0.0036 _NEW_LINE_  _NEW_LINE_  _NEW_LINE_ human health: _NEW_LINE_ organism only: _NEW_LINE_  _NEW_LINE_ aldrin 0.000050 _NEW_LINE_ ammonia _NEW_LINE_ arsenic (iii), total dissolved _NEW_LINE_ arsen
6	aldrin	1683	1689	173	ndosulfan 0.0087 _NEW_LINE_ endosulfan sulfate _NEW_LINE_ endrin 0.0023 _NEW_LINE_ heptachlor 0.0036 _NEW_LINE_  _NEW_LINE_  _NEW_LINE_ human health: _NEW_LINE_ organism only: _NEW_LINE_  _NEW_LINE_ aldrin 0.000050 _NEW_LINE_ ammonia _NEW_LINE_ arsenic (iii), total dissolved _NEW_LINE_ arsenic, total dissolved 24 _NEW_LINE_ cadmium, total dissolve
7	ammonia	1699	1706	173	 _NEW_LINE_ endosulfan sulfate _NEW_LINE_ endrin 0.0023 _NEW_LINE_ heptachlor 0.0036 _NEW_LINE_  _NEW_LINE_  _NEW_LINE_ human health: _NEW_LINE_ organism only: _NEW_LINE_  _NEW_LINE_ aldrin 0.000050 _NEW_LINE_ ammonia _NEW_LINE_ arsenic (iii), total dissolved _NEW_LINE_ arsenic, total dissolved 24 _NEW_LINE_ cadmium, total dissolved 168 _NEW_LINE_ chlordane 0
7	arsenic	1707	1714	173	fan sulfate _NEW_LINE_ endrin 0.0023 _NEW_LINE_ heptachlor 0.0036 _NEW_LINE_  _NEW_LINE_  _NEW_LINE_ human health: _NEW_LINE_ organism only: _NEW_LINE_  _NEW_LINE_ aldrin 0.000050 _NEW_LINE_ ammonia _NEW_LINE_ arsenic (iii), total dissolved _NEW_LINE_ arsenic, total dissolved 24 _NEW_LINE_ cadmium, total dissolved 168 _NEW_LINE_ chlordane 0.00081 _NEW_LINE_ c
7	arsenic	1738	1745	173	chlor 0.0036 _NEW_LINE_  _NEW_LINE_  _NEW_LINE_ human health: _NEW_LINE_ organism only: _NEW_LINE_  _NEW_LINE_ aldrin 0.000050 _NEW_LINE_ ammonia _NEW_LINE_ arsenic (iii), total dissolved _NEW_LINE_ arsenic, total dissolved 24 _NEW_LINE_ cadmium, total dissolved 168 _NEW_LINE_ chlordane 0.00081 _NEW_LINE_ chlorine _NEW_LINE_ chromium (hex), total d
7	cadmium	1766	1773	173	 _NEW_LINE_ organism only: _NEW_LINE_  _NEW_LINE_ aldrin 0.000050 _NEW_LINE_ ammonia _NEW_LINE_ arsenic (iii), total dissolved _NEW_LINE_ arsenic, total dissolved 24 _NEW_LINE_ cadmium, total dissolved 168 _NEW_LINE_ chlordane 0.00081 _NEW_LINE_ chlorine _NEW_LINE_ chromium (hex), total dissolved 1470 _NEW_LINE_ chromium (iii)
9	chlordane	1795	1804	173	050 _NEW_LINE_ ammonia _NEW_LINE_ arsenic (iii), total dissolved _NEW_LINE_ arsenic, total dissolved 24 _NEW_LINE_ cadmium, total dissolved 168 _NEW_LINE_ chlordane 0.00081 _NEW_LINE_ chlorine _NEW_LINE_ chromium (hex), total dissolved 1470 _NEW_LINE_ chromium (iii), total dissolved 140468 _NEW_LINE_ copper
8	chlorine	1813	1821	173	c (iii), total dissolved _NEW_LINE_ arsenic, total dissolved 24 _NEW_LINE_ cadmium, total dissolved 168 _NEW_LINE_ chlordane 0.00081 _NEW_LINE_ chlorine _NEW_LINE_ chromium (hex), total dissolved 1470 _NEW_LINE_ chromium (iii), total dissolved 140468 _NEW_LINE_ copper, total dissolved
8	chromium	1822	1830	173	total dissolved _NEW_LINE_ arsenic, total dissolved 24 _NEW_LINE_ cadmium, total dissolved 168 _NEW_LINE_ chlordane 0.00081 _NEW_LINE_ chlorine _NEW_LINE_ chromium (hex), total dissolved 1470 _NEW_LINE_ chromium (iii), total dissolved 140468 _NEW_LINE_ copper, total dissolved 1000 _NEW_LINE_ cya
8	chromium	1859	1867	173	ved 24 _NEW_LINE_ cadmium, total dissolved 168 _NEW_LINE_ chlordane 0.00081 _NEW_LINE_ chlorine _NEW_LINE_ chromium (hex), total dissolved 1470 _NEW_LINE_ chromium (iii), total dissolved 140468 _NEW_LINE_ copper, total dissolved 1000 _NEW_LINE_ cyanide 140 _NEW_LINE_ 4,4 ddt 0.00022 _NEW_LINE_ dieldrin 0.0
6	copper	1898	1904	173	ordane 0.00081 _NEW_LINE_ chlorine _NEW_LINE_ chromium (hex), total dissolved 1470 _NEW_LINE_ chromium (iii), total dissolved 140468 _NEW_LINE_ copper, total dissolved 1000 _NEW_LINE_ cyanide 140 _NEW_LINE_ 4,4 ddt 0.00022 _NEW_LINE_ dieldrin 0.000054 _NEW_LINE_ 2,3,7,8 tcdd (dioxin) 51 x 10-9
7	cyanide	1927	1934	173	ium (hex), total dissolved 1470 _NEW_LINE_ chromium (iii), total dissolved 140468 _NEW_LINE_ copper, total dissolved 1000 _NEW_LINE_ cyanide 140 _NEW_LINE_ 4,4 ddt 0.00022 _NEW_LINE_ dieldrin 0.000054 _NEW_LINE_ 2,3,7,8 tcdd (dioxin) 51 x 10-9 _NEW_LINE_ alpha-endosulfan 89 _NEW_LINE_ beta-endo
7	4,4 ddt	1939	1946	173	otal dissolved 1470 _NEW_LINE_ chromium (iii), total dissolved 140468 _NEW_LINE_ copper, total dissolved 1000 _NEW_LINE_ cyanide 140 _NEW_LINE_ 4,4 ddt 0.00022 _NEW_LINE_ dieldrin 0.000054 _NEW_LINE_ 2,3,7,8 tcdd (dioxin) 51 x 10-9 _NEW_LINE_ alpha-endosulfan 89 _NEW_LINE_ beta-endosulfan 89 _NEW_LINE_ en
8	dieldrin	1955	1963	173	470 _NEW_LINE_ chromium (iii), total dissolved 140468 _NEW_LINE_ copper, total dissolved 1000 _NEW_LINE_ cyanide 140 _NEW_LINE_ 4,4 ddt 0.00022 _NEW_LINE_ dieldrin 0.000054 _NEW_LINE_ 2,3,7,8 tcdd (dioxin) 51 x 10-9 _NEW_LINE_ alpha-endosulfan 89 _NEW_LINE_ beta-endosulfan 89 _NEW_LINE_ endosulfan sulfate 
12	2,3,7,8 tcdd	1973	1985	173	, total dissolved 140468 _NEW_LINE_ copper, total dissolved 1000 _NEW_LINE_ cyanide 140 _NEW_LINE_ 4,4 ddt 0.00022 _NEW_LINE_ dieldrin 0.000054 _NEW_LINE_ 2,3,7,8 tcdd (dioxin) 51 x 10-9 _NEW_LINE_ alpha-endosulfan 89 _NEW_LINE_ beta-endosulfan 89 _NEW_LINE_ endosulfan sulfate 89 _NEW_LINE_ endrin 0.060 _NEW_LINE_ heptac
6	dioxin	1987	1993	173	ved 140468 _NEW_LINE_ copper, total dissolved 1000 _NEW_LINE_ cyanide 140 _NEW_LINE_ 4,4 ddt 0.00022 _NEW_LINE_ dieldrin 0.000054 _NEW_LINE_ 2,3,7,8 tcdd (dioxin) 51 x 10-9 _NEW_LINE_ alpha-endosulfan 89 _NEW_LINE_ beta-endosulfan 89 _NEW_LINE_ endosulfan sulfate 89 _NEW_LINE_ endrin 0.060 _NEW_LINE_ heptachlor 0.0
16	alpha-endosulfan	2005	2021	173	 total dissolved 1000 _NEW_LINE_ cyanide 140 _NEW_LINE_ 4,4 ddt 0.00022 _NEW_LINE_ dieldrin 0.000054 _NEW_LINE_ 2,3,7,8 tcdd (dioxin) 51 x 10-9 _NEW_LINE_ alpha-endosulfan 89 _NEW_LINE_ beta-endosulfan 89 _NEW_LINE_ endosulfan sulfate 89 _NEW_LINE_ endrin 0.060 _NEW_LINE_ heptachlor 0.000079 _NEW_LINE_  _NEW_LINE_  _NEW_LINE_ human health: _NEW_LINE_ water 
15	beta-endosulfan	2025	2040	173	0 _NEW_LINE_ cyanide 140 _NEW_LINE_ 4,4 ddt 0.00022 _NEW_LINE_ dieldrin 0.000054 _NEW_LINE_ 2,3,7,8 tcdd (dioxin) 51 x 10-9 _NEW_LINE_ alpha-endosulfan 89 _NEW_LINE_ beta-endosulfan 89 _NEW_LINE_ endosulfan sulfate 89 _NEW_LINE_ endrin 0.060 _NEW_LINE_ heptachlor 0.000079 _NEW_LINE_  _NEW_LINE_  _NEW_LINE_ human health: _NEW_LINE_ water & organisms: _NEW_LINE_  _NEW_LINE_ aldri
10	endosulfan	2044	2054	173	dt 0.00022 _NEW_LINE_ dieldrin 0.000054 _NEW_LINE_ 2,3,7,8 tcdd (dioxin) 51 x 10-9 _NEW_LINE_ alpha-endosulfan 89 _NEW_LINE_ beta-endosulfan 89 _NEW_LINE_ endosulfan sulfate 89 _NEW_LINE_ endrin 0.060 _NEW_LINE_ heptachlor 0.000079 _NEW_LINE_  _NEW_LINE_  _NEW_LINE_ human health: _NEW_LINE_ water & organisms: _NEW_LINE_  _NEW_LINE_ aldrin 0.000049 _NEW_LINE_ amm
7	sulfate	2055	2062	173	dieldrin 0.000054 _NEW_LINE_ 2,3,7,8 tcdd (dioxin) 51 x 10-9 _NEW_LINE_ alpha-endosulfan 89 _NEW_LINE_ beta-endosulfan 89 _NEW_LINE_ endosulfan sulfate 89 _NEW_LINE_ endrin 0.060 _NEW_LINE_ heptachlor 0.000079 _NEW_LINE_  _NEW_LINE_  _NEW_LINE_ human health: _NEW_LINE_ water & organisms: _NEW_LINE_  _NEW_LINE_ aldrin 0.000049 _NEW_LINE_ ammonia _NEW_LINE_ ars
6	endrin	2066	2072	173	000054 _NEW_LINE_ 2,3,7,8 tcdd (dioxin) 51 x 10-9 _NEW_LINE_ alpha-endosulfan 89 _NEW_LINE_ beta-endosulfan 89 _NEW_LINE_ endosulfan sulfate 89 _NEW_LINE_ endrin 0.060 _NEW_LINE_ heptachlor 0.000079 _NEW_LINE_  _NEW_LINE_  _NEW_LINE_ human health: _NEW_LINE_ water & organisms: _NEW_LINE_  _NEW_LINE_ aldrin 0.000049 _NEW_LINE_ ammonia _NEW_LINE_ arsenic (iii)
10	heptachlor	2079	2089	173	8 tcdd (dioxin) 51 x 10-9 _NEW_LINE_ alpha-endosulfan 89 _NEW_LINE_ beta-endosulfan 89 _NEW_LINE_ endosulfan sulfate 89 _NEW_LINE_ endrin 0.060 _NEW_LINE_ heptachlor 0.000079 _NEW_LINE_  _NEW_LINE_  _NEW_LINE_ human health: _NEW_LINE_ water & organisms: _NEW_LINE_  _NEW_LINE_ aldrin 0.000049 _NEW_LINE_ ammonia _NEW_LINE_ arsenic (iii), total dissolved
6	aldrin	2135	2141	173	ulfan 89 _NEW_LINE_ endosulfan sulfate 89 _NEW_LINE_ endrin 0.060 _NEW_LINE_ heptachlor 0.000079 _NEW_LINE_  _NEW_LINE_  _NEW_LINE_ human health: _NEW_LINE_ water & organisms: _NEW_LINE_  _NEW_LINE_ aldrin 0.000049 _NEW_LINE_ ammonia _NEW_LINE_ arsenic (iii), total dissolved _NEW_LINE_ arsenic, total dissolved 0.078 _NEW_LINE_ cadmium, total disso
7	ammonia	2151	2158	173	fan sulfate 89 _NEW_LINE_ endrin 0.060 _NEW_LINE_ heptachlor 0.000079 _NEW_LINE_  _NEW_LINE_  _NEW_LINE_ human health: _NEW_LINE_ water & organisms: _NEW_LINE_  _NEW_LINE_ aldrin 0.000049 _NEW_LINE_ ammonia _NEW_LINE_ arsenic (iii), total dissolved _NEW_LINE_ arsenic, total dissolved 0.078 _NEW_LINE_ cadmium, total dissolved 5 _NEW_LINE_ chlordane 
7	arsenic	2159	2166	173	ate 89 _NEW_LINE_ endrin 0.060 _NEW_LINE_ heptachlor 0.000079 _NEW_LINE_  _NEW_LINE_  _NEW_LINE_ human health: _NEW_LINE_ water & organisms: _NEW_LINE_  _NEW_LINE_ aldrin 0.000049 _NEW_LINE_ ammonia _NEW_LINE_ arsenic (iii), total dissolved _NEW_LINE_ arsenic, total dissolved 0.078 _NEW_LINE_ cadmium, total dissolved 5 _NEW_LINE_ chlordane 0.00080 _NEW_LINE_ 
7	arsenic	2190	2197	173	0.000079 _NEW_LINE_  _NEW_LINE_  _NEW_LINE_ human health: _NEW_LINE_ water & organisms: _NEW_LINE_  _NEW_LINE_ aldrin 0.000049 _NEW_LINE_ ammonia _NEW_LINE_ arsenic (iii), total dissolved _NEW_LINE_ arsenic, total dissolved 0.078 _NEW_LINE_ cadmium, total dissolved 5 _NEW_LINE_ chlordane 0.00080 _NEW_LINE_ chlorine _NEW_LINE_ chromium (hex), total 
7	cadmium	2221	2228	173	& organisms: _NEW_LINE_  _NEW_LINE_ aldrin 0.000049 _NEW_LINE_ ammonia _NEW_LINE_ arsenic (iii), total dissolved _NEW_LINE_ arsenic, total dissolved 0.078 _NEW_LINE_ cadmium, total dissolved 5 _NEW_LINE_ chlordane 0.00080 _NEW_LINE_ chlorine _NEW_LINE_ chromium (hex), total dissolved 98 _NEW_LINE_ chromium (iii), to
9	chlordane	2248	2257	173	49 _NEW_LINE_ ammonia _NEW_LINE_ arsenic (iii), total dissolved _NEW_LINE_ arsenic, total dissolved 0.078 _NEW_LINE_ cadmium, total dissolved 5 _NEW_LINE_ chlordane 0.00080 _NEW_LINE_ chlorine _NEW_LINE_ chromium (hex), total dissolved 98 _NEW_LINE_ chromium (iii), total dissolved 100 _NEW_LINE_ copper, tot
8	chlorine	2266	2274	173	 (iii), total dissolved _NEW_LINE_ arsenic, total dissolved 0.078 _NEW_LINE_ cadmium, total dissolved 5 _NEW_LINE_ chlordane 0.00080 _NEW_LINE_ chlorine _NEW_LINE_ chromium (hex), total dissolved 98 _NEW_LINE_ chromium (iii), total dissolved 100 _NEW_LINE_ copper, total dissolved 1300
8	chromium	2275	2283	173	otal dissolved _NEW_LINE_ arsenic, total dissolved 0.078 _NEW_LINE_ cadmium, total dissolved 5 _NEW_LINE_ chlordane 0.00080 _NEW_LINE_ chlorine _NEW_LINE_ chromium (hex), total dissolved 98 _NEW_LINE_ chromium (iii), total dissolved 100 _NEW_LINE_ copper, total dissolved 1300 _NEW_LINE_ cyanide 
8	chromium	2310	2318	173	lved 0.078 _NEW_LINE_ cadmium, total dissolved 5 _NEW_LINE_ chlordane 0.00080 _NEW_LINE_ chlorine _NEW_LINE_ chromium (hex), total dissolved 98 _NEW_LINE_ chromium (iii), total dissolved 100 _NEW_LINE_ copper, total dissolved 1300 _NEW_LINE_ cyanide 140 _NEW_LINE_ 4,4 ddt 0.00022 _NEW_LINE_ dieldrin 0.0000
6	copper	2346	2352	173	5 _NEW_LINE_ chlordane 0.00080 _NEW_LINE_ chlorine _NEW_LINE_ chromium (hex), total dissolved 98 _NEW_LINE_ chromium (iii), total dissolved 100 _NEW_LINE_ copper, total dissolved 1300 _NEW_LINE_ cyanide 140 _NEW_LINE_ 4,4 ddt 0.00022 _NEW_LINE_ dieldrin 0.000052 _NEW_LINE_ 2,3,7,8 tcdd (dioxin) 50 x 10 -
7	cyanide	2375	2382	173	chromium (hex), total dissolved 98 _NEW_LINE_ chromium (iii), total dissolved 100 _NEW_LINE_ copper, total dissolved 1300 _NEW_LINE_ cyanide 140 _NEW_LINE_ 4,4 ddt 0.00022 _NEW_LINE_ dieldrin 0.000052 _NEW_LINE_ 2,3,7,8 tcdd (dioxin) 50 x 10 -9 _NEW_LINE_ alpha-endosulfan 62 _NEW_LINE_ beta-end
7	4,4 ddt	2387	2394	173	x), total dissolved 98 _NEW_LINE_ chromium (iii), total dissolved 100 _NEW_LINE_ copper, total dissolved 1300 _NEW_LINE_ cyanide 140 _NEW_LINE_ 4,4 ddt 0.00022 _NEW_LINE_ dieldrin 0.000052 _NEW_LINE_ 2,3,7,8 tcdd (dioxin) 50 x 10 -9 _NEW_LINE_ alpha-endosulfan 62 _NEW_LINE_ beta-endosulfan 62 _NEW_LINE_ e
8	dieldrin	2403	2411	173	ved 98 _NEW_LINE_ chromium (iii), total dissolved 100 _NEW_LINE_ copper, total dissolved 1300 _NEW_LINE_ cyanide 140 _NEW_LINE_ 4,4 ddt 0.00022 _NEW_LINE_ dieldrin 0.000052 _NEW_LINE_ 2,3,7,8 tcdd (dioxin) 50 x 10 -9 _NEW_LINE_ alpha-endosulfan 62 _NEW_LINE_ beta-endosulfan 62 _NEW_LINE_ endosulfan sulfate
12	2,3,7,8 tcdd	2421	2433	173	ii), total dissolved 100 _NEW_LINE_ copper, total dissolved 1300 _NEW_LINE_ cyanide 140 _NEW_LINE_ 4,4 ddt 0.00022 _NEW_LINE_ dieldrin 0.000052 _NEW_LINE_ 2,3,7,8 tcdd (dioxin) 50 x 10 -9 _NEW_LINE_ alpha-endosulfan 62 _NEW_LINE_ beta-endosulfan 62 _NEW_LINE_ endosulfan sulfate 62 _NEW_LINE_ endrin 0.059 _NEW_LINE_ hepta
6	dioxin	2435	2441	173	solved 100 _NEW_LINE_ copper, total dissolved 1300 _NEW_LINE_ cyanide 140 _NEW_LINE_ 4,4 ddt 0.00022 _NEW_LINE_ dieldrin 0.000052 _NEW_LINE_ 2,3,7,8 tcdd (dioxin) 50 x 10 -9 _NEW_LINE_ alpha-endosulfan 62 _NEW_LINE_ beta-endosulfan 62 _NEW_LINE_ endosulfan sulfate 62 _NEW_LINE_ endrin 0.059 _NEW_LINE_ heptachlor 00
16	alpha-endosulfan	2454	2470	173	ieldrin 0.000052 _NEW_LINE_ 2,3,7,8 tcdd (dioxin) 50 x 10 -9 _NEW_LINE_ alpha-endosulfan 62 _NEW_LINE_ beta-endosulfan 62 _NEW_LINE_ endosulfan sulfate 62 _NEW_LINE_ endri
15	beta-endosulfan	2474	2489	173	,7,8 tcdd (dioxin) 50 x 10 -9 _NEW_LINE_ alpha-endosulfan 62 _NEW_LINE_ beta-endosulfan 62 _NEW_LINE_ endosulfan sulfate 62 _NEW_LINE_ endrin 0.059 _NEW_LINE_ heptachlor 
10	endosulfan	2493	2503	173	sulfan 62 _NEW_LINE_ endosulfan sulfate 6
7	sulfate	2504	2511	173	ndosulfan sulfate 62 _NEW_LINE_ endrin
6	endrin	2515	2521	173	ulfate 62 _NEW_LINE_ endrin 0.059 _NEW_LINE_ hep
9	gamma-bhc	21	30	174	: _NEW_LINE_ acute: _NEW_LINE_  _NEW_LINE_ gamma-bhc (lindane)
7	lindane	32	39	174	amma-bhc (lindane) 0.95 _NEW_LINE_ lea
4	lead	46	50	174	ane) 0.95 _NEW_LINE_ lead, total di
7	mercury	71	78	174	gamma-bhc (lindane) 0.95 _NEW_LINE_ lead, total dissolved 30 _NEW_LINE_ mercury (ii), total dissolved 2.1 _NEW_LINE_ mercury _NEW_LINE_ nickel, total d
7	mercury	105	112	174	 water: _NEW_LINE_ acute: _NEW_LINE_  _NEW_LINE_ gamma-bhc (lindane) 0.95 _NEW_LINE_ lead, total dissolved 30 _NEW_LINE_ mercury (ii), total dissolved 2.1 _NEW_LINE_ mercury _NEW_LINE_ nickel, total dissolved 260 _NEW_LINE_ phenol 300 _NEW_LINE_ pentachlorophenol 8.7 _NEW_LINE_ total pcb 0.02 _NEW_LINE_ selenium, total dissolv
6	nickel	113	119	174	acute: _NEW_LINE_  _NEW_LINE_ gamma-bhc (lindane) 0.95 _NEW_LINE_ lead, total dissolved 30 _NEW_LINE_ mercury (ii), total dissolved 2.1 _NEW_LINE_ mercury _NEW_LINE_ nickel, total dissolved 260 _NEW_LINE_ phenol 300 _NEW_LINE_ pentachlorophenol 8.7 _NEW_LINE_ total pcb 0.02 _NEW_LINE_ selenium, total dissolved 11.8
6	phenol	141	147	174	0.95 _NEW_LINE_ lead, total dissolved 30 _NEW_LINE_ mercury (ii), total dissolved 2.1 _NEW_LINE_ mercury _NEW_LINE_ nickel, total dissolved 260 _NEW_LINE_ phenol 300 _NEW_LINE_ pentachlorophenol 8.7 _NEW_LINE_ total pcb 0.02 _NEW_LINE_ selenium, total dissolved 11.8 _NEW_LINE_ silver, total dissolved 0.9
17	pentachlorophenol	152	169	174	total dissolved 30 _NEW_LINE_ mercury (ii), total dissolved 2.1 _NEW_LINE_ mercury _NEW_LINE_ nickel, total dissolved 260 _NEW_LINE_ phenol 300 _NEW_LINE_ pentachlorophenol 8.7 _NEW_LINE_ total pcb 0.02 _NEW_LINE_ selenium, total dissolved 11.8 _NEW_LINE_ silver, total dissolved 0.98 _NEW_LINE_ toxaphene 0.73 _NEW_LINE_ zinc,
9	total pcb	174	183	174	cury (ii), total dissolved 2.1 _NEW_LINE_ mercury _NEW_LINE_ nickel, total dissolved 260 _NEW_LINE_ phenol 300 _NEW_LINE_ pentachlorophenol 8.7 _NEW_LINE_ total pcb 0.02 _NEW_LINE_ selenium, total dissolved 11.8 _NEW_LINE_ silver, total dissolved 0.98 _NEW_LINE_ toxaphene 0.73 _NEW_LINE_ zinc, total dissolv
8	selenium	189	197	174	l dissolved 2.1 _NEW_LINE_ mercury _NEW_LINE_ nickel, total dissolved 260 _NEW_LINE_ phenol 300 _NEW_LINE_ pentachlorophenol 8.7 _NEW_LINE_ total pcb 0.02 _NEW_LINE_ selenium, total dissolved 11.8 _NEW_LINE_ silver, total dissolved 0.98 _NEW_LINE_ toxaphene 0.73 _NEW_LINE_ zinc, total dissolved 65 _NEW_LINE_  _NEW_LINE_ fresh w
6	silver	220	226	174	 total dissolved 260 _NEW_LINE_ phenol 300 _NEW_LINE_ pentachlorophenol 8.7 _NEW_LINE_ total pcb 0.02 _NEW_LINE_ selenium, total dissolved 11.8 _NEW_LINE_ silver, total dissolved 0.98 _NEW_LINE_ toxaphene 0.73 _NEW_LINE_ zinc, total dissolved 65 _NEW_LINE_  _NEW_LINE_ fresh water: _NEW_LINE_ chronic: _NEW_LINE_  _NEW_LINE_ gamma-bhc (li
9	toxaphene	249	258	174	00 _NEW_LINE_ pentachlorophenol 8.7 _NEW_LINE_ total pcb 0.02 _NEW_LINE_ selenium, total dissolved 11.8 _NEW_LINE_ silver, total dissolved 0.98 _NEW_LINE_ toxaphene 0.73 _NEW_LINE_ zinc, total dissolved 65 _NEW_LINE_  _NEW_LINE_ fresh water: _NEW_LINE_ chronic: _NEW_LINE_  _NEW_LINE_ gamma-bhc (lindane) 0.08 _NEW_LINE_ lead, total dissolve
4	zinc	264	268	174	henol 8.7 _NEW_LINE_ total pcb 0.02 _NEW_LINE_ selenium, total dissolved 11.8 _NEW_LINE_ silver, total dissolved 0.98 _NEW_LINE_ toxaphene 0.73 _NEW_LINE_ zinc, total dissolved 65 _NEW_LINE_  _NEW_LINE_ fresh water: _NEW_LINE_ chronic: _NEW_LINE_  _NEW_LINE_ gamma-bhc (lindane) 0.08 _NEW_LINE_ lead, total dissolved 1.18 _NEW_LINE_ mer
9	gamma-bhc	313	322	174	d 11.8 _NEW_LINE_ silver, total dissolved 0.98 _NEW_LINE_ toxaphene 0.73 _NEW_LINE_ zinc, total dissolved 65 _NEW_LINE_  _NEW_LINE_ fresh water: _NEW_LINE_ chronic: _NEW_LINE_  _NEW_LINE_ gamma-bhc (lindane) 0.08 _NEW_LINE_ lead, total dissolved 1.18 _NEW_LINE_ mercury (ii), total dissolved 0.012 _NEW_LINE_ mercury _NEW_LINE_ nickel, total
7	lindane	324	331	174	er, total dissolved 0.98 _NEW_LINE_ toxaphene 0.73 _NEW_LINE_ zinc, total dissolved 65 _NEW_LINE_  _NEW_LINE_ fresh water: _NEW_LINE_ chronic: _NEW_LINE_  _NEW_LINE_ gamma-bhc (lindane) 0.08 _NEW_LINE_ lead, total dissolved 1.18 _NEW_LINE_ mercury (ii), total dissolved 0.012 _NEW_LINE_ mercury _NEW_LINE_ nickel, total dissolve
4	lead	338	342	174	olved 0.98 _NEW_LINE_ toxaphene 0.73 _NEW_LINE_ zinc, total dissolved 65 _NEW_LINE_  _NEW_LINE_ fresh water: _NEW_LINE_ chronic: _NEW_LINE_  _NEW_LINE_ gamma-bhc (lindane) 0.08 _NEW_LINE_ lead, total dissolved 1.18 _NEW_LINE_ mercury (ii), total dissolved 0.012 _NEW_LINE_ mercury _NEW_LINE_ nickel, total dissolved 29 _NEW_LINE_ phenol
7	mercury	365	372	174	inc, total dissolved 65 _NEW_LINE_  _NEW_LINE_ fresh water: _NEW_LINE_ chronic: _NEW_LINE_  _NEW_LINE_ gamma-bhc (lindane) 0.08 _NEW_LINE_ lead, total dissolved 1.18 _NEW_LINE_ mercury (ii), total dissolved 0.012 _NEW_LINE_ mercury _NEW_LINE_ nickel, total dissolved 29 _NEW_LINE_ phenol 102 _NEW_LINE_ pentachlorophenol 6.7 _NEW_LINE_ tot
7	mercury	401	408	174	: _NEW_LINE_ chronic: _NEW_LINE_  _NEW_LINE_ gamma-bhc (lindane) 0.08 _NEW_LINE_ lead, total dissolved 1.18 _NEW_LINE_ mercury (ii), total dissolved 0.012 _NEW_LINE_ mercury _NEW_LINE_ nickel, total dissolved 29 _NEW_LINE_ phenol 102 _NEW_LINE_ pentachlorophenol 6.7 _NEW_LINE_ total pcb 0.014 _NEW_LINE_ selenium, total dissolv
6	nickel	409	415	174	c: _NEW_LINE_  _NEW_LINE_ gamma-bhc (lindane) 0.08 _NEW_LINE_ lead, total dissolved 1.18 _NEW_LINE_ mercury (ii), total dissolved 0.012 _NEW_LINE_ mercury _NEW_LINE_ nickel, total dissolved 29 _NEW_LINE_ phenol 102 _NEW_LINE_ pentachlorophenol 6.7 _NEW_LINE_ total pcb 0.014 _NEW_LINE_ selenium, total dissolved 4.6 _NEW_LINE_ 
6	phenol	436	442	174	8 _NEW_LINE_ lead, total dissolved 1.18 _NEW_LINE_ mercury (ii), total dissolved 0.012 _NEW_LINE_ mercury _NEW_LINE_ nickel, total dissolved 29 _NEW_LINE_ phenol 102 _NEW_LINE_ pentachlorophenol 6.7 _NEW_LINE_ total pcb 0.014 _NEW_LINE_ selenium, total dissolved 4.6 _NEW_LINE_ silver, total dissolved _NEW_LINE_ tox
17	pentachlorophenol	447	464	174	al dissolved 1.18 _NEW_LINE_ mercury (ii), total dissolved 0.012 _NEW_LINE_ mercury _NEW_LINE_ nickel, total dissolved 29 _NEW_LINE_ phenol 102 _NEW_LINE_ pentachlorophenol 6.7 _NEW_LINE_ total pcb 0.014 _NEW_LINE_ selenium, total dissolved 4.6 _NEW_LINE_ silver, total dissolved _NEW_LINE_ toxaphene 0.0002 _NEW_LINE_ zinc, to
9	total pcb	469	478	174	ury (ii), total dissolved 0.012 _NEW_LINE_ mercury _NEW_LINE_ nickel, total dissolved 29 _NEW_LINE_ phenol 102 _NEW_LINE_ pentachlorophenol 6.7 _NEW_LINE_ total pcb 0.014 _NEW_LINE_ selenium, total dissolved 4.6 _NEW_LINE_ silver, total dissolved _NEW_LINE_ toxaphene 0.0002 _NEW_LINE_ zinc, total dissolved 
8	selenium	485	493	174	dissolved 0.012 _NEW_LINE_ mercury _NEW_LINE_ nickel, total dissolved 29 _NEW_LINE_ phenol 102 _NEW_LINE_ pentachlorophenol 6.7 _NEW_LINE_ total pcb 0.014 _NEW_LINE_ selenium, total dissolved 4.6 _NEW_LINE_ silver, total dissolved _NEW_LINE_ toxaphene 0.0002 _NEW_LINE_ zinc, total dissolved 65 _NEW_LINE_  _NEW_LINE_ salt water:
6	silver	515	521	174	, total dissolved 29 _NEW_LINE_ phenol 102 _NEW_LINE_ pentachlorophenol 6.7 _NEW_LINE_ total pcb 0.014 _NEW_LINE_ selenium, total dissolved 4.6 _NEW_LINE_ silver, total dissolved _NEW_LINE_ toxaphene 0.0002 _NEW_LINE_ zinc, total dissolved 65 _NEW_LINE_  _NEW_LINE_ salt water: _NEW_LINE_ acute: _NEW_LINE_  _NEW_LINE_ gamma-bhc (lindane)
9	toxaphene	539	548	174	nol 102 _NEW_LINE_ pentachlorophenol 6.7 _NEW_LINE_ total pcb 0.014 _NEW_LINE_ selenium, total dissolved 4.6 _NEW_LINE_ silver, total dissolved _NEW_LINE_ toxaphene 0.0002 _NEW_LINE_ zinc, total dissolved 65 _NEW_LINE_  _NEW_LINE_ salt water: _NEW_LINE_ acute: _NEW_LINE_  _NEW_LINE_ gamma-bhc (lindane) 0.16 _NEW_LINE_ lead, total dissolved
4	zinc	556	560	174	rophenol 6.7 _NEW_LINE_ total pcb 0.014 _NEW_LINE_ selenium, total dissolved 4.6 _NEW_LINE_ silver, total dissolved _NEW_LINE_ toxaphene 0.0002 _NEW_LINE_ zinc, total dissolved 65 _NEW_LINE_  _NEW_LINE_ salt water: _NEW_LINE_ acute: _NEW_LINE_  _NEW_LINE_ gamma-bhc (lindane) 0.16 _NEW_LINE_ lead, total dissolved 210 _NEW_LINE_ mercury
9	gamma-bhc	602	611	174	issolved 4.6 _NEW_LINE_ silver, total dissolved _NEW_LINE_ toxaphene 0.0002 _NEW_LINE_ zinc, total dissolved 65 _NEW_LINE_  _NEW_LINE_ salt water: _NEW_LINE_ acute: _NEW_LINE_  _NEW_LINE_ gamma-bhc (lindane) 0.16 _NEW_LINE_ lead, total dissolved 210 _NEW_LINE_ mercury (ii), total dissolved 1.8 _NEW_LINE_ mercury _NEW_LINE_ nickel, total di
7	lindane	613	620	174	6 _NEW_LINE_ silver, total dissolved _NEW_LINE_ toxaphene 0.0002 _NEW_LINE_ zinc, total dissolved 65 _NEW_LINE_  _NEW_LINE_ salt water: _NEW_LINE_ acute: _NEW_LINE_  _NEW_LINE_ gamma-bhc (lindane) 0.16 _NEW_LINE_ lead, total dissolved 210 _NEW_LINE_ mercury (ii), total dissolved 1.8 _NEW_LINE_ mercury _NEW_LINE_ nickel, total dissolved 7
4	lead	627	631	174	l dissolved _NEW_LINE_ toxaphene 0.0002 _NEW_LINE_ zinc, total dissolved 65 _NEW_LINE_  _NEW_LINE_ salt water: _NEW_LINE_ acute: _NEW_LINE_  _NEW_LINE_ gamma-bhc (lindane) 0.16 _NEW_LINE_ lead, total dissolved 210 _NEW_LINE_ mercury (ii), total dissolved 1.8 _NEW_LINE_ mercury _NEW_LINE_ nickel, total dissolved 75 _NEW_LINE_ phenol 30
7	mercury	653	660	174	02 _NEW_LINE_ zinc, total dissolved 65 _NEW_LINE_  _NEW_LINE_ salt water: _NEW_LINE_ acute: _NEW_LINE_  _NEW_LINE_ gamma-bhc (lindane) 0.16 _NEW_LINE_ lead, total dissolved 210 _NEW_LINE_ mercury (ii), total dissolved 1.8 _NEW_LINE_ mercury _NEW_LINE_ nickel, total dissolved 75 _NEW_LINE_ phenol 300 _NEW_LINE_ pentachlorophenol 13 _NEW_LINE_ total 
7	mercury	687	694	174	water: _NEW_LINE_ acute: _NEW_LINE_  _NEW_LINE_ gamma-bhc (lindane) 0.16 _NEW_LINE_ lead, total dissolved 210 _NEW_LINE_ mercury (ii), total dissolved 1.8 _NEW_LINE_ mercury _NEW_LINE_ nickel, total dissolved 75 _NEW_LINE_ phenol 300 _NEW_LINE_ pentachlorophenol 13 _NEW_LINE_ total pcb 1.0 _NEW_LINE_ selenium, total dissolved 
6	nickel	695	701	174	cute: _NEW_LINE_  _NEW_LINE_ gamma-bhc (lindane) 0.16 _NEW_LINE_ lead, total dissolved 210 _NEW_LINE_ mercury (ii), total dissolved 1.8 _NEW_LINE_ mercury _NEW_LINE_ nickel, total dissolved 75 _NEW_LINE_ phenol 300 _NEW_LINE_ pentachlorophenol 13 _NEW_LINE_ total pcb 1.0 _NEW_LINE_ selenium, total dissolved 290 _NEW_LINE_ sil
6	phenol	722	728	174	0.16 _NEW_LINE_ lead, total dissolved 210 _NEW_LINE_ mercury (ii), total dissolved 1.8 _NEW_LINE_ mercury _NEW_LINE_ nickel, total dissolved 75 _NEW_LINE_ phenol 300 _NEW_LINE_ pentachlorophenol 13 _NEW_LINE_ total pcb 1.0 _NEW_LINE_ selenium, total dissolved 290 _NEW_LINE_ silver, total dissolved 1.9 _NEW_LINE_ to
17	pentachlorophenol	733	750	174	total dissolved 210 _NEW_LINE_ mercury (ii), total dissolved 1.8 _NEW_LINE_ mercury _NEW_LINE_ nickel, total dissolved 75 _NEW_LINE_ phenol 300 _NEW_LINE_ pentachlorophenol 13 _NEW_LINE_ total pcb 1.0 _NEW_LINE_ selenium, total dissolved 290 _NEW_LINE_ silver, total dissolved 1.9 _NEW_LINE_ toxaphene 0.21 _NEW_LINE_ zinc, tot
9	total pcb	754	763	174	ercury (ii), total dissolved 1.8 _NEW_LINE_ mercury _NEW_LINE_ nickel, total dissolved 75 _NEW_LINE_ phenol 300 _NEW_LINE_ pentachlorophenol 13 _NEW_LINE_ total pcb 1.0 _NEW_LINE_ selenium, total dissolved 290 _NEW_LINE_ silver, total dissolved 1.9 _NEW_LINE_ toxaphene 0.21 _NEW_LINE_ zinc, total dissolved 
8	selenium	768	776	174	otal dissolved 1.8 _NEW_LINE_ mercury _NEW_LINE_ nickel, total dissolved 75 _NEW_LINE_ phenol 300 _NEW_LINE_ pentachlorophenol 13 _NEW_LINE_ total pcb 1.0 _NEW_LINE_ selenium, total dissolved 290 _NEW_LINE_ silver, total dissolved 1.9 _NEW_LINE_ toxaphene 0.21 _NEW_LINE_ zinc, total dissolved 90 _NEW_LINE_  _NEW_LINE_  _NEW_LINE_ salt wat
6	silver	798	804	174	kel, total dissolved 75 _NEW_LINE_ phenol 300 _NEW_LINE_ pentachlorophenol 13 _NEW_LINE_ total pcb 1.0 _NEW_LINE_ selenium, total dissolved 290 _NEW_LINE_ silver, total dissolved 1.9 _NEW_LINE_ toxaphene 0.21 _NEW_LINE_ zinc, total dissolved 90 _NEW_LINE_  _NEW_LINE_  _NEW_LINE_ salt water: _NEW_LINE_ chronic: _NEW_LINE_  _NEW_LINE_ gamma-bhc (lin
9	toxaphene	826	835	174	ol 300 _NEW_LINE_ pentachlorophenol 13 _NEW_LINE_ total pcb 1.0 _NEW_LINE_ selenium, total dissolved 290 _NEW_LINE_ silver, total dissolved 1.9 _NEW_LINE_ toxaphene 0.21 _NEW_LINE_ zinc, total dissolved 90 _NEW_LINE_  _NEW_LINE_  _NEW_LINE_ salt water: _NEW_LINE_ chronic: _NEW_LINE_  _NEW_LINE_ gamma-bhc (lindane) _NEW_LINE_ lead, total dissolved 8.1
4	zinc	841	845	174	orophenol 13 _NEW_LINE_ total pcb 1.0 _NEW_LINE_ selenium, total dissolved 290 _NEW_LINE_ silver, total dissolved 1.9 _NEW_LINE_ toxaphene 0.21 _NEW_LINE_ zinc, total dissolved 90 _NEW_LINE_  _NEW_LINE_  _NEW_LINE_ salt water: _NEW_LINE_ chronic: _NEW_LINE_  _NEW_LINE_ gamma-bhc (lindane) _NEW_LINE_ lead, total dissolved 8.1 _NEW_LINE_ mercury (
9	gamma-bhc	890	899	174	ved 290 _NEW_LINE_ silver, total dissolved 1.9 _NEW_LINE_ toxaphene 0.21 _NEW_LINE_ zinc, total dissolved 90 _NEW_LINE_  _NEW_LINE_  _NEW_LINE_ salt water: _NEW_LINE_ chronic: _NEW_LINE_  _NEW_LINE_ gamma-bhc (lindane) _NEW_LINE_ lead, total dissolved 8.1 _NEW_LINE_ mercury (ii), total dissolved 0.025 _NEW_LINE_ mercury _NEW_LINE_ nickel, total disso
7	lindane	901	908	174	ver, total dissolved 1.9 _NEW_LINE_ toxaphene 0.21 _NEW_LINE_ zinc, total dissolved 90 _NEW_LINE_  _NEW_LINE_  _NEW_LINE_ salt water: _NEW_LINE_ chronic: _NEW_LINE_  _NEW_LINE_ gamma-bhc (lindane) _NEW_LINE_ lead, total dissolved 8.1 _NEW_LINE_ mercury (ii), total dissolved 0.025 _NEW_LINE_ mercury _NEW_LINE_ nickel, total dissolved 8.3 _NEW_LINE_ 
4	lead	910	914	174	l dissolved 1.9 _NEW_LINE_ toxaphene 0.21 _NEW_LINE_ zinc, total dissolved 90 _NEW_LINE_  _NEW_LINE_  _NEW_LINE_ salt water: _NEW_LINE_ chronic: _NEW_LINE_  _NEW_LINE_ gamma-bhc (lindane) _NEW_LINE_ lead, total dissolved 8.1 _NEW_LINE_ mercury (ii), total dissolved 0.025 _NEW_LINE_ mercury _NEW_LINE_ nickel, total dissolved 8.3 _NEW_LINE_ phenol
7	mercury	936	943	174	0.21 _NEW_LINE_ zinc, total dissolved 90 _NEW_LINE_  _NEW_LINE_  _NEW_LINE_ salt water: _NEW_LINE_ chronic: _NEW_LINE_  _NEW_LINE_ gamma-bhc (lindane) _NEW_LINE_ lead, total dissolved 8.1 _NEW_LINE_ mercury (ii), total dissolved 0.025 _NEW_LINE_ mercury _NEW_LINE_ nickel, total dissolved 8.3 _NEW_LINE_ phenol 58 _NEW_LINE_ pentachlorophenol 7.9 _NEW_LINE_ tot
7	mercury	972	979	174	 water: _NEW_LINE_ chronic: _NEW_LINE_  _NEW_LINE_ gamma-bhc (lindane) _NEW_LINE_ lead, total dissolved 8.1 _NEW_LINE_ mercury (ii), total dissolved 0.025 _NEW_LINE_ mercury _NEW_LINE_ nickel, total dissolved 8.3 _NEW_LINE_ phenol 58 _NEW_LINE_ pentachlorophenol 7.9 _NEW_LINE_ total pcb 0.03 _NEW_LINE_ selenium, total dissolve
6	nickel	980	986	174	chronic: _NEW_LINE_  _NEW_LINE_ gamma-bhc (lindane) _NEW_LINE_ lead, total dissolved 8.1 _NEW_LINE_ mercury (ii), total dissolved 0.025 _NEW_LINE_ mercury _NEW_LINE_ nickel, total dissolved 8.3 _NEW_LINE_ phenol 58 _NEW_LINE_ pentachlorophenol 7.9 _NEW_LINE_ total pcb 0.03 _NEW_LINE_ selenium, total dissolved 71 _NEW_LINE_ si
6	phenol	1008	1014	174	) _NEW_LINE_ lead, total dissolved 8.1 _NEW_LINE_ mercury (ii), total dissolved 0.025 _NEW_LINE_ mercury _NEW_LINE_ nickel, total dissolved 8.3 _NEW_LINE_ phenol 58 _NEW_LINE_ pentachlorophenol 7.9 _NEW_LINE_ total pcb 0.03 _NEW_LINE_ selenium, total dissolved 71 _NEW_LINE_ silver, total dissolved _NEW_LINE_ toxaph
17	pentachlorophenol	1018	1035	174	tal dissolved 8.1 _NEW_LINE_ mercury (ii), total dissolved 0.025 _NEW_LINE_ mercury _NEW_LINE_ nickel, total dissolved 8.3 _NEW_LINE_ phenol 58 _NEW_LINE_ pentachlorophenol 7.9 _NEW_LINE_ total pcb 0.03 _NEW_LINE_ selenium, total dissolved 71 _NEW_LINE_ silver, total dissolved _NEW_LINE_ toxaphene 0.0002 _NEW_LINE_ zinc, tota
9	total pcb	1040	1049	174	ury (ii), total dissolved 0.025 _NEW_LINE_ mercury _NEW_LINE_ nickel, total dissolved 8.3 _NEW_LINE_ phenol 58 _NEW_LINE_ pentachlorophenol 7.9 _NEW_LINE_ total pcb 0.03 _NEW_LINE_ selenium, total dissolved 71 _NEW_LINE_ silver, total dissolved _NEW_LINE_ toxaphene 0.0002 _NEW_LINE_ zinc, total dissolved 81
8	selenium	1055	1063	174	 dissolved 0.025 _NEW_LINE_ mercury _NEW_LINE_ nickel, total dissolved 8.3 _NEW_LINE_ phenol 58 _NEW_LINE_ pentachlorophenol 7.9 _NEW_LINE_ total pcb 0.03 _NEW_LINE_ selenium, total dissolved 71 _NEW_LINE_ silver, total dissolved _NEW_LINE_ toxaphene 0.0002 _NEW_LINE_ zinc, total dissolved 81 _NEW_LINE_  _NEW_LINE_  _NEW_LINE_ human healt
6	silver	1084	1090	174	el, total dissolved 8.3 _NEW_LINE_ phenol 58 _NEW_LINE_ pentachlorophenol 7.9 _NEW_LINE_ total pcb 0.03 _NEW_LINE_ selenium, total dissolved 71 _NEW_LINE_ silver, total dissolved _NEW_LINE_ toxaphene 0.0002 _NEW_LINE_ zinc, total dissolved 81 _NEW_LINE_  _NEW_LINE_  _NEW_LINE_ human health: _NEW_LINE_ organism only: _NEW_LINE_ gamma-bhc
9	toxaphene	1108	1117	174	phenol 58 _NEW_LINE_ pentachlorophenol 7.9 _NEW_LINE_ total pcb 0.03 _NEW_LINE_ selenium, total dissolved 71 _NEW_LINE_ silver, total dissolved _NEW_LINE_ toxaphene 0.0002 _NEW_LINE_ zinc, total dissolved 81 _NEW_LINE_  _NEW_LINE_  _NEW_LINE_ human health: _NEW_LINE_ organism only: _NEW_LINE_ gamma-bhc (lindane) 1.8 _NEW_LINE_ lead, total 
4	zinc	1125	1129	174	lorophenol 7.9 _NEW_LINE_ total pcb 0.03 _NEW_LINE_ selenium, total dissolved 71 _NEW_LINE_ silver, total dissolved _NEW_LINE_ toxaphene 0.0002 _NEW_LINE_ zinc, total dissolved 81 _NEW_LINE_  _NEW_LINE_  _NEW_LINE_ human health: _NEW_LINE_ organism only: _NEW_LINE_ gamma-bhc (lindane) 1.8 _NEW_LINE_ lead, total dissolved _NEW_LINE_ me
9	gamma-bhc	1181	1190	174	71 _NEW_LINE_ silver, total dissolved _NEW_LINE_ toxaphene 0.0002 _NEW_LINE_ zinc, total dissolved 81 _NEW_LINE_  _NEW_LINE_  _NEW_LINE_ human health: _NEW_LINE_ organism only: _NEW_LINE_ gamma-bhc (lindane) 1.8 _NEW_LINE_ lead, total dissolved _NEW_LINE_ mercury (ii), total dissolved _NEW_LINE_ mercury 0.153 _NEW_LINE_ nickel, total disso
7	lindane	1192	1199	174	total dissolved _NEW_LINE_ toxaphene 0.0002 _NEW_LINE_ zinc, total dissolved 81 _NEW_LINE_  _NEW_LINE_  _NEW_LINE_ human health: _NEW_LINE_ organism only: _NEW_LINE_ gamma-bhc (lindane) 1.8 _NEW_LINE_ lead, total dissolved _NEW_LINE_ mercury (ii), total dissolved _NEW_LINE_ mercury 0.153 _NEW_LINE_ nickel, total dissolved 4600
4	lead	1205	1209	174	ed _NEW_LINE_ toxaphene 0.0002 _NEW_LINE_ zinc, total dissolved 81 _NEW_LINE_  _NEW_LINE_  _NEW_LINE_ human health: _NEW_LINE_ organism only: _NEW_LINE_ gamma-bhc (lindane) 1.8 _NEW_LINE_ lead, total dissolved _NEW_LINE_ mercury (ii), total dissolved _NEW_LINE_ mercury 0.153 _NEW_LINE_ nickel, total dissolved 4600 _NEW_LINE_ phenol 86
7	mercury	1227	1234	174	nc, total dissolved 81 _NEW_LINE_  _NEW_LINE_  _NEW_LINE_ human health: _NEW_LINE_ organism only: _NEW_LINE_ gamma-bhc (lindane) 1.8 _NEW_LINE_ lead, total dissolved _NEW_LINE_ mercury (ii), total dissolved _NEW_LINE_ mercury 0.153 _NEW_LINE_ nickel, total dissolved 4600 _NEW_LINE_ phenol 860000 _NEW_LINE_ pentachlorophenol 3.
7	mercury	1257	1264	174	 health: _NEW_LINE_ organism only: _NEW_LINE_ gamma-bhc (lindane) 1.8 _NEW_LINE_ lead, total dissolved _NEW_LINE_ mercury (ii), total dissolved _NEW_LINE_ mercury 0.153 _NEW_LINE_ nickel, total dissolved 4600 _NEW_LINE_ phenol 860000 _NEW_LINE_ pentachlorophenol 3.0 _NEW_LINE_ total pcb 0.000064 _NEW_LINE_ selenium,
6	nickel	1271	1277	174	ism only: _NEW_LINE_ gamma-bhc (lindane) 1.8 _NEW_LINE_ lead, total dissolved _NEW_LINE_ mercury (ii), total dissolved _NEW_LINE_ mercury 0.153 _NEW_LINE_ nickel, total dissolved 4600 _NEW_LINE_ phenol 860000 _NEW_LINE_ pentachlorophenol 3.0 _NEW_LINE_ total pcb 0.000064 _NEW_LINE_ selenium, total dissol
6	phenol	1300	1306	174	 1.8 _NEW_LINE_ lead, total dissolved _NEW_LINE_ mercury (ii), total dissolved _NEW_LINE_ mercury 0.153 _NEW_LINE_ nickel, total dissolved 4600 _NEW_LINE_ phenol 860000 _NEW_LINE_ pentachlorophenol 3.0 _NEW_LINE_ total pcb 0.000064 _NEW_LINE_ selenium, total dissolved 4200 _NEW_LINE_ silver, total dissol
17	pentachlorophenol	1314	1331	174	al dissolved _NEW_LINE_ mercury (ii), total dissolved _NEW_LINE_ mercury 0.153 _NEW_LINE_ nickel, total dissolved 4600 _NEW_LINE_ phenol 860000 _NEW_LINE_ pentachlorophenol 3.0 _NEW_LINE_ total pcb 0.000064 _NEW_LINE_ selenium, total dissolved 4200 _NEW_LINE_ silver, total dissolved _NEW_LINE_ toxaphene 0.00028 _NEW_LINE_ zin
9	total pcb	1336	1345	174	ii), total dissolved _NEW_LINE_ mercury 0.153 _NEW_LINE_ nickel, total dissolved 4600 _NEW_LINE_ phenol 860000 _NEW_LINE_ pentachlorophenol 3.0 _NEW_LINE_ total pcb 0.000064 _NEW_LINE_ selenium, total dissolved 4200 _NEW_LINE_ silver, total dissolved _NEW_LINE_ toxaphene 0.00028 _NEW_LINE_ zinc, total disso
8	selenium	1355	1363	174	d _NEW_LINE_ mercury 0.153 _NEW_LINE_ nickel, total dissolved 4600 _NEW_LINE_ phenol 860000 _NEW_LINE_ pentachlorophenol 3.0 _NEW_LINE_ total pcb 0.000064 _NEW_LINE_ selenium, total dissolved 4200 _NEW_LINE_ silver, total dissolved _NEW_LINE_ toxaphene 0.00028 _NEW_LINE_ zinc, total dissolved 26,000 _NEW_LINE_  _NEW_LINE_  _NEW_LINE_  _NEW_LINE_ hum
6	silver	1386	1392	174	issolved 4600 _NEW_LINE_ phenol 860000 _NEW_LINE_ pentachlorophenol 3.0 _NEW_LINE_ total pcb 0.000064 _NEW_LINE_ selenium, total dissolved 4200 _NEW_LINE_ silver, total dissolved _NEW_LINE_ toxaphene 0.00028 _NEW_LINE_ zinc, total dissolved 26,000 _NEW_LINE_  _NEW_LINE_  _NEW_LINE_  _NEW_LINE_ human health: _NEW_LINE_ water & organisms:
9	toxaphene	1410	1419	174	000 _NEW_LINE_ pentachlorophenol 3.0 _NEW_LINE_ total pcb 0.000064 _NEW_LINE_ selenium, total dissolved 4200 _NEW_LINE_ silver, total dissolved _NEW_LINE_ toxaphene 0.00028 _NEW_LINE_ zinc, total dissolved 26,000 _NEW_LINE_  _NEW_LINE_  _NEW_LINE_  _NEW_LINE_ human health: _NEW_LINE_ water & organisms: _NEW_LINE_  _NEW_LINE_ gamma-bhc (lindane) 0.98 _NEW_LINE_ 
4	zinc	1428	1432	174	nol 3.0 _NEW_LINE_ total pcb 0.000064 _NEW_LINE_ selenium, total dissolved 4200 _NEW_LINE_ silver, total dissolved _NEW_LINE_ toxaphene 0.00028 _NEW_LINE_ zinc, total dissolved 26,000 _NEW_LINE_  _NEW_LINE_  _NEW_LINE_  _NEW_LINE_ human health: _NEW_LINE_ water & organisms: _NEW_LINE_  _NEW_LINE_ gamma-bhc (lindane) 0.98 _NEW_LINE_ lead, total d
9	gamma-bhc	1494	1503	174	total dissolved _NEW_LINE_ toxaphene 0.00028 _NEW_LINE_ zinc, total dissolved 26,000 _NEW_LINE_  _NEW_LINE_  _NEW_LINE_  _NEW_LINE_ human health: _NEW_LINE_ water & organisms: _NEW_LINE_  _NEW_LINE_ gamma-bhc (lindane) 0.98 _NEW_LINE_ lead, total dissolved 15 _NEW_LINE_ mercury (ii), total dissolved _NEW_LINE_ mercury 0.151 _NEW_LINE_ nickel, total d
7	lindane	1505	1512	174	lved _NEW_LINE_ toxaphene 0.00028 _NEW_LINE_ zinc, total dissolved 26,000 _NEW_LINE_  _NEW_LINE_  _NEW_LINE_  _NEW_LINE_ human health: _NEW_LINE_ water & organisms: _NEW_LINE_  _NEW_LINE_ gamma-bhc (lindane) 0.98 _NEW_LINE_ lead, total dissolved 15 _NEW_LINE_ mercury (ii), total dissolved _NEW_LINE_ mercury 0.151 _NEW_LINE_ nickel, total dissolved 
4	lead	1519	1523	174	 0.00028 _NEW_LINE_ zinc, total dissolved 26,000 _NEW_LINE_  _NEW_LINE_  _NEW_LINE_  _NEW_LINE_ human health: _NEW_LINE_ water & organisms: _NEW_LINE_  _NEW_LINE_ gamma-bhc (lindane) 0.98 _NEW_LINE_ lead, total dissolved 15 _NEW_LINE_ mercury (ii), total dissolved _NEW_LINE_ mercury 0.151 _NEW_LINE_ nickel, total dissolved 610 _NEW_LINE_ phenol 
7	mercury	1544	1551	174	olved 26,000 _NEW_LINE_  _NEW_LINE_  _NEW_LINE_  _NEW_LINE_ human health: _NEW_LINE_ water & organisms: _NEW_LINE_  _NEW_LINE_ gamma-bhc (lindane) 0.98 _NEW_LINE_ lead, total dissolved 15 _NEW_LINE_ mercury (ii), total dissolved _NEW_LINE_ mercury 0.151 _NEW_LINE_ nickel, total dissolved 610 _NEW_LINE_ phenol 10000 _NEW_LINE_ pentachlorophenol 0.27
7	mercury	1574	1581	174	water & organisms: _NEW_LINE_  _NEW_LINE_ gamma-bhc (lindane) 0.98 _NEW_LINE_ lead, total dissolved 15 _NEW_LINE_ mercury (ii), total dissolved _NEW_LINE_ mercury 0.151 _NEW_LINE_ nickel, total dissolved 610 _NEW_LINE_ phenol 10000 _NEW_LINE_ pentachlorophenol 0.27 _NEW_LINE_ total pcb 0.000064 _NEW_LINE_ selenium, 
6	nickel	1588	1594	174	sms: _NEW_LINE_  _NEW_LINE_ gamma-bhc (lindane) 0.98 _NEW_LINE_ lead, total dissolved 15 _NEW_LINE_ mercury (ii), total dissolved _NEW_LINE_ mercury 0.151 _NEW_LINE_ nickel, total dissolved 610 _NEW_LINE_ phenol 10000 _NEW_LINE_ pentachlorophenol 0.27 _NEW_LINE_ total pcb 0.000064 _NEW_LINE_ selenium, total dissolv
6	phenol	1616	1622	174	98 _NEW_LINE_ lead, total dissolved 15 _NEW_LINE_ mercury (ii), total dissolved _NEW_LINE_ mercury 0.151 _NEW_LINE_ nickel, total dissolved 610 _NEW_LINE_ phenol 10000 _NEW_LINE_ pentachlorophenol 0.27 _NEW_LINE_ total pcb 0.000064 _NEW_LINE_ selenium, total dissolved 170 _NEW_LINE_ silver, total dissolv
17	pentachlorophenol	1629	1646	174	l dissolved 15 _NEW_LINE_ mercury (ii), total dissolved _NEW_LINE_ mercury 0.151 _NEW_LINE_ nickel, total dissolved 610 _NEW_LINE_ phenol 10000 _NEW_LINE_ pentachlorophenol 0.27 _NEW_LINE_ total pcb 0.000064 _NEW_LINE_ selenium, total dissolved 170 _NEW_LINE_ silver, total dissolved 100 _NEW_LINE_ toxaphene 0.00028
9	total pcb	1652	1661	174	(ii), total dissolved _NEW_LINE_ mercury 0.151 _NEW_LINE_ nickel, total dissolved 610 _NEW_LINE_ phenol 10000 _NEW_LINE_ pentachlorophenol 0.27 _NEW_LINE_ total pcb 0.000064 _NEW_LINE_ selenium, total dissolved 170 _NEW_LINE_ silver, total dissolved 100 _NEW_LINE_ toxaphene 0.00028 _NEW_LINE_ zinc, total di
8	selenium	1671	1679	174	l 10000 _NEW_LINE_ pentachlorophenol 0.27 _NEW_LINE_ total pcb 0.000064 _NEW_LINE_ selenium, total dissolved 170 _NEW_LINE_ silver, total dissolved 100 _NEW_LINE_ 
6	silver	1701	1707	174	 _NEW_LINE_ total pcb 0.000064 _NEW_LINE_ selenium, total dissolved 170 _NEW_LINE_ silver, total dissolved 100 _NEW_LINE_ toxaphene 0.00028 _NEW_LINE_ zinc, tota
9	toxaphene	1729	1738	174	olved 100 _NEW_LINE_ toxaphene 0.00028 _NEW_LINE_ z
4	zinc	1747	1751	174	e 0.00028 _NEW_LINE_ zinc, total di
8	chlorine	969	977	484	hich will be multiplied _NEW_LINE_                             by a factor of 20. _NEW_LINE_  _NEW_LINE_                             chlorine toxicity problem factor = (1.0 mg/l - the new maximum _NEW_LINE_                             chlorine concentr